AAAAATATTCG -> AAAATATTCGG
AAAATATTCGG -> AAATATTCGGG
AAAATTGTCAT -> AAATTGTCATT
AAACACTGCTG -> AACACTGCTGC
AAACAGTGGTC -> AACAGTGGTCG
AAACCCGCCCC -> AACCCGCCCCT
AAACCTAGCAT -> AACCTAGCATC
AAACCTGCAAC -> AACCTGCAACG
AAACGCTAGCC -> AACGCTAGCCG
AAACGTAATGC -> AACGTAATGCT
AAAGATAGACC -> AAGATAGACCG
AAAGATTTCAT -> AAGATTTCATA
AAAGCACCACT -> AAGCACCACTG
AAAGCATTGCG -> AAGCATTGCGG
AAAGGCCGCAG -> AAGGCCGCAGT
AAAGTGGAAGT -> AAGTGGAAGTA
AAAGTTGGCGT -> AAGTTGGCGTT
AAATAACAAAC -> AATAACAAACA
AAATATTCGGG -> AATATTCGGGG
AAATCAAGAAT -> AATCAAGAATC
AAATCAGGTCA -> AATCAGGTCAC
AAATGGCATGC -> AATGGCATGCT
AAATGGCGTTA -> AATGGCGTTAT
AAATGTCCGAT -> AATGTCCGATG
AAATTGTCATT -> AATTGTCATTT
AACAAACACTG -> ACAAACACTGC
AACACACAAAC -> ACACACAAACA
AACACTATAAG -> ACACTATAAGT
AACACTGCTGC -> ACACTGCTGCG
AACAGAAGCCG -> ACAGAAGCCGC
AACAGGTCGCC -> ACAGGTCGCCT
AACAGTGGTCG -> ACAGTGGTCGC
AACATAAGGAA -> ACATAAGGAAG
AACATCCGAAT -> ACATCCGAATT
AACATGATCTT -> ACATGATCTTC
AACCCATCTTT -> ACCCATCTTTT
AACCCGCCCCT -> ACCCGCCCCTC
AACCGCCTCGC -> ACCGCCTCGCA
AACCGCTTGAC -> ACCGCTTGACA
AACCTAGCATC -> ACCTAGCATCA
AACCTGCAACG -> ACCTGCAACGA
AACGAAGTCGG -> ACGAAGTCGGG
AACGAATCAAG -> ACGAATCAAGC
AACGATGACCC -> ACGATGACCCG
AACGCCGCTTC -> ACGCCGCTTCG
AACGCTAGCAC -> ACGCTAGCACA
AACGCTAGCCG -> ACGCTAGCCGT
AACGGCTGCAG -> ACGGCTGCAGC
AACGTAATGCT -> ACGTAATGCTT
AACGTACCTCC -> ACGTACCTCCA
AACTACCACTG -> ACTACCACTGT
AACTACCTACC -> ACTACCTACCG
AAGAATCCTCG -> AGAATCCTCGG
AAGAGTCTGGG -> AGAGTCTGGGG
AAGATAAAGCA -> AGATAAAGCAT
AAGATAGACCG -> AGATAGACCGG
AAGATTTCATA -> AGATTTCATAC
AAGCACCACTG -> AGCACCACTGA
AAGCACTCACC -> AGCACTCACCG
AAGCAGCCAAT -> AGCAGCCAATT
AAGCATTGCGG -> AGCATTGCGGC
AAGCCGCCTAG -> AGCCGCCTAGA
AAGCGCCACGA -> AGCGCCACGAG
AAGCTCCGAAT -> AGCTCCGAATC
AAGGAAGTATT -> AGGAAGTATTC
AAGGAGAGCGG -> AGGAGAGCGGG
AAGGAGTTGGA -> AGGAGTTGGAA
AAGGATAGTGT -> AGGATAGTGTT
AAGGCCGCAGT -> AGGCCGCAGTC
AAGGCTCTAGA -> AGGCTCTAGAG
AAGGGAACACT -> AGGGAACACTA
AAGGTGTCCGA -> AGGTGTCCGAT
AAGGTTCGATG -> AGGTTCGATGA
AAGTACGATTG -> AGTACGATTGG
AAGTATTCAGT -> AGTATTCAGTG
AAGTCGCGGGA -> AGTCGCGGGAT
AAGTCGGGCCC -> AGTCGGGCCCA
AAGTGGAAGTA -> AGTGGAAGTAC
AAGTTCTAAAT -> AGTTCTAAATC
AAGTTGGCGTT -> AGTTGGCGTTC
AAGTTTAGCGT -> AGTTTAGCGTT
AAGTTTGTAGC -> AGTTTGTAGCG
AATAAAGTGGA -> ATAAAGTGGAA
AATAACAAACA -> ATAACAAACAC
AATAACGTACC -> ATAACGTACCT
AATACATGGAT -> ATACATGGATC
AATACCGGCAG -> ATACCGGCAGG
AATACGTACGG -> ATACGTACGGT
AATAGCCTATT -> ATAGCCTATTT
AATAGTAAAGA -> ATAGTAAAGAT
AATAGTTCTGG -> ATAGTTCTGGA
AATATTCGGGG -> ATATTCGGGGC
AATCAAGAATC -> ATCAAGAATCC
AATCAAGCAGC -> ATCAAGCAGCC
AATCAATTTGA -> ATCAATTTGAA
AATCAGGTCAC -> ATCAGGTCACG
AATCATTCCCC -> ATCATTCCCCT
AATCCCCTGGG -> ATCCCCTGGGA
AATCCTCGGCG -> ATCCTCGGCGC
AATCTACAGCT -> ATCTACAGCTT
AATCTACCTCA -> ATCTACCTCAA
AATGACTCAAC -> ATGACTCAACG
AATGCTTGATT -> ATGCTTGATTG
AATGGCACCGC -> ATGGCACCGCT
AATGGCATGCT -> ATGGCATGCTT
AATGGCGTTAT -> ATGGCGTTATG
AATGGGTCTTC -> ATGGGTCTTCG
AATGTCAGTGG -> ATGTCAGTGGA
AATGTCCGATG -> ATGTCCGATGT
AATGTCTTAGA -> ATGTCTTAGAA
AATTAGGAAGC -> ATTAGGAAGCT
AATTATGAGAC -> ATTATGAGACA
AATTCACCTTG -> ATTCACCTTGG
AATTCAGGTCA -> ATTCAGGTCAG
AATTCCAGAAA -> ATTCCAGAAAG
AATTCGATGCA -> ATTCGATGCAC
AATTGCTATTC -> ATTGCTATTCG
AATTGTCATTT -> ATTGTCATTTA
AATTGTTGCCG -> ATTGTTGCCGC
AATTTGAAGTT -> ATTTGAAGTTT
ACAAACACTGC -> CAAACACTGCT
ACAAACAGTGG -> CAAACAGTGGT
ACAAAGATTTC -> CAAAGATTTCA
ACAACATAAGG -> CAACATAAGGA
ACAAGGAGAGC -> CAAGGAGAGCG
ACAATAGCCTA -> CAATAGCCTAT
ACAATCTACCT -> CAATCTACCTC
ACAATGGCACC -> CAATGGCACCG
ACACAAACAGT -> CACAAACAGTG
ACACACAAACA -> CACACAAACAG
ACACGAAGTTT -> CACGAAGTTTA
ACACGAGATCC -> CACGAGATCCA
ACACTATAAGT -> CACTATAAGTT
ACACTGCTGCG -> CACTGCTGCGG
ACAGAAGCCGC -> CAGAAGCCGCC
ACAGCCCCACT -> CAGCCCCACTG
ACAGCTTGAGA -> CAGCTTGAGAC
ACAGGCAATTC -> CAGGCAATTCG
ACAGGTCGCCT -> CAGGTCGCCTC
ACAGTGGTCGC -> CAGTGGTCGCC
ACAGTTTCACT -> CAGTTTCACTA
ACATAAGGAAG -> CATAAGGAAGT
ACATAGGGGCG -> CATAGGGGCGC
ACATCCGAATT -> CATCCGAATTG
ACATGAAAAAT -> CATGAAAAATA
ACATGATCTTC -> CATGATCTTCA
ACATGGATCAC -> CATGGATCACT
ACATGGATCGC -> CATGGATCGCT
ACATTCTCCGT -> CATTCTCCGTC
ACATTGATACT -> CATTGATACTT
ACCACTGAGCG -> CCACTGAGCGC
ACCACTGTAAC -> CCACTGTAACC
ACCATCAAATG -> CCATCAAATGG
ACCCAGACGGC -> CCCAGACGGCC
ACCCAGCAGCC -> CCCAGCAGCCC
ACCCAGGCAAA -> CCCAGGCAAAG
ACCCATAGGGA -> CCCATAGGGAC
ACCCATCTTTT -> CCCATCTTTTG
ACCCATGCAGT -> CCCATGCAGTG
ACCCGACGATT -> CCCGACGATTT
ACCCGCCCCTC -> CCCGCCCCTCA
ACCCTCCTCTT -> CCCTCCTCTTT
ACCCTCGTGTG -> CCCTCGTGTGT
ACCGAACATGA -> CCGAACATGAT
ACCGAGAACGC -> CCGAGAACGCT
ACCGCCTCGCA -> CCGCCTCGCAG
ACCGCTACGCG -> CCGCTACGCGA
ACCGCTTGACA -> CCGCTTGACAA
ACCGGATTAGG -> CCGGATTAGGT
ACCGGCAGGCC -> CCGGCAGGCCG
ACCGGGTGTCC -> CCGGGTGTCCC
ACCGTAATTCA -> CCGTAATTCAG
ACCGTAGAATA -> CCGTAGAATAG
ACCGTCTGAAA -> CCGTCTGAAAC
ACCTAACAGGT -> CCTAACAGGTC
ACCTACCGTAG -> CCTACCGTAGA
ACCTAGCATCA -> CCTAGCATCAA
ACCTCAATTGT -> CCTCAATTGTT
ACCTCCAGTAT -> CCTCCAGTATA
ACCTCGATGGG -> CCTCGATGGGA
ACCTCTCTGAA -> CCTCTCTGAAG
ACCTGCAACGA -> CCTGCAACGAT
ACCTTAACGCC -> CCTTAACGCCG
ACCTTGGTTTC -> CCTTGGTTTCA
ACGAAGTCGGG -> CGAAGTCGGGC
ACGAAGTTTAG -> CGAAGTTTAGC
ACGAATCAAGC -> CGAATCAAGCA
ACGAGATCCAA -> CGAGATCCAAT
ACGAGCGACAA -> CGAGCGACAAC
ACGAGTGCCCC -> CGAGTGCCCCG
ACGATCCCCAA -> CGATCCCCAAT
ACGATGACCCG -> CGATGACCCGA
ACGATGTATTT -> CGATGTATTTA
ACGATTGGTGT -> CGATTGGTGTG
ACGATTTCGGG -> CGATTTCGGGA
ACGCATCCTCG -> CGCATCCTCGA
ACGCCGCTTCG -> CGCCGCTTCGA
ACGCGACCTCT -> CGCGACCTCTC
ACGCGATCCGA -> CGCGATCCGAA
ACGCTAGCACA -> CGCTAGCACAT
ACGCTAGCCGT -> CGCTAGCCGTG
ACGCTTCCAAA -> CGCTTCCAAAA
ACGGACCCTCG -> CGGACCCTCGT
ACGGCATATCA -> CGGCATATCAA
ACGGCCTCAGA -> CGGCCTCAGAG
ACGGCGGTCCT -> CGGCGGTCCTC
ACGGCTGCAGC -> CGGCTGCAGCA
ACGGTTAGGCC -> CGGTTAGGCCG
ACGGTTGAAGA -> CGGTTGAAGAT
ACGTAATGCTT -> CGTAATGCTTG
ACGTACCGTCT -> CGTACCGTCTG
ACGTACCTCCA -> CGTACCTCCAG
ACGTACGGTTA -> CGTACGGTTAG
ACGTCCAAGCG -> CGTCCAAGCGC
ACGTCCACAGC -> CGTCCACAGCC
ACGTGCAAACG -> CGTGCAAACGC
ACGTTTACACG -> CGTTTACACGA
ACTACCACTGT -> CTACCACTGTA
ACTACCTACCG -> CTACCTACCGT
ACTACGGTTGA -> CTACGGTTGAA
ACTAGGTGCAG -> CTAGGTGCAGG
ACTAGTAAATG -> CTAGTAAATGT
ACTAGTTGGAC -> CTAGTTGGACC
ACTATAAGTTC -> CTATAAGTTCT
ACTCAACGGCT -> CTCAACGGCTG
ACTCACCGTAA -> CTCACCGTAAT
ACTCATCATCA -> CTCATCATCAA
ACTCCACGATG -> CTCCACGATGT
ACTCTTCGAAA -> CTCTTCGAAAT
ACTGACTAGTT -> CTGACTAGTTG
ACTGAGCGCAA -> CTGAGCGCAAA
ACTGATTTTCC -> CTGATTTTCCT
ACTGCTGCGGT -> CTGCTGCGGTG
ACTGCTTACTC -> CTGCTTACTCC
ACTGTAACCGC -> CTGTAACCGCC
ACTTACAATGG -> CTTACAATGGC
ACTTACTCATC -> CTTACTCATCA
ACTTGGGGCCC -> CTTGGGGCCCC
AGAAAGTTGGC -> GAAAGTTGGCG
AGAACGCTAGC -> GAACGCTAGCA
AGAACTACCTA -> GAACTACCTAC
AGAAGCCGCCT -> GAAGCCGCCTA
AGAAGGTTCGA -> GAAGGTTCGAT
AGAATAAAGTG -> GAATAAAGTGG
AGAATAACGTA -> GAATAACGTAC
AGAATACGTAC -> GAATACGTACG
AGAATAGTAAA -> GAATAGTAAAG
AGAATCCTCGG -> GAATCCTCGGC
AGACAATCTAC -> GACAATCTACC
AGACCCATGCA -> GACCCATGCAG
AGACCGGGTGT -> GACCGGGTGTC
AGACCTTAACG -> GACCTTAACGC
AGACGCTTCCA -> GACGCTTCCAA
AGACGGCCTCA -> GACGGCCTCAG
AGACTCTTCGA -> GACTCTTCGAA
AGAGCAGTTAA -> GAGCAGTTAAC
AGAGCGGGCCT -> GAGCGGGCCTT
AGAGTCTACAT -> GAGTCTACATA
AGAGTCTGGGG -> GAGTCTGGGGT
AGATAAAGCAT -> GATAAAGCATT
AGATAGACCGG -> GATAGACCGGG
AGATATAAGCA -> GATATAAGCAC
AGATCCAATTC -> GATCCAATTCA
AGATGAGACCT -> GATGAGACCTT
AGATGTGTGTA -> GATGTGTGTAG
AGATTTCATAC -> GATTTCATACG
AGCACATTCTC -> GCACATTCTCC
AGCACCACTGA -> GCACCACTGAG
AGCACGGACCC -> GCACGGACCCT
AGCACTCACCG -> GCACTCACCGT
AGCACTTACAA -> GCACTTACAAT
AGCAGCCAATT -> GCAGCCAATTA
AGCAGCCCCTG -> GCAGCCCCTGG
AGCAGGTTTCG -> GCAGGTTTCGA
AGCAGTTAACA -> GCAGTTAACAG
AGCATCAACTA -> GCATCAACTAC
AGCATTGCGGC -> GCATTGCGGCT
AGCCAATTATG -> GCCAATTATGA
AGCCCCACTGA -> GCCCCACTGAT
AGCCCCTGGTT -> GCCCCTGGTTA
AGCCGCCTAGA -> GCCGCCTAGAT
AGCCGTGACCC -> GCCGTGACCCT
AGCCTATTTAT -> GCCTATTTATA
AGCGACAACAT -> GCGACAACATA
AGCGACATGAA -> GCGACATGAAA
AGCGAGAAGGT -> GCGAGAAGGTT
AGCGCAAACCC -> GCGCAAACCCG
AGCGCATTCAA -> GCGCATTCAAG
AGCGCCACGAG -> GCGCCACGAGC
AGCGCGTACGT -> GCGCGTACGTA
AGCGGACGATC -> GCGGACGATCC
AGCGGGCCTTA -> GCGGGCCTTAT
AGCGTTGATTC -> GCGTTGATTCA
AGCTAAGAGTC -> GCTAAGAGTCT
AGCTACCGAGA -> GCTACCGAGAA
AGCTACGAGTG -> GCTACGAGTGC
AGCTAGATGAG -> GCTAGATGAGA
AGCTATCTGCA -> GCTATCTGCAC
AGCTCCGAATC -> GCTCCGAATCA
AGCTTAATAGT -> GCTTAATAGTT
AGCTTGAGACC -> GCTTGAGACCC
AGGAAGCTCCG -> GGAAGCTCCGA
AGGAAGTATTC -> GGAAGTATTCA
AGGAGAGCGGG -> GGAGAGCGGGC
AGGAGTTGGAA -> GGAGTTGGAAA
AGGATAGTGTT -> GGATAGTGTTA
AGGCAAAGCAC -> GGCAAAGCACC
AGGCAAGGTGT -> GGCAAGGTGTC
AGGCAATTCGA -> GGCAATTCGAT
AGGCCGCAACC -> GGCCGCAACCG
AGGCCGCAGTC -> GGCCGCAGTCA
AGGCCGGCTAT -> GGCCGGCTATC
AGGCGCGGACA -> GGCGCGGACAT
AGGCTAATGGG -> GGCTAATGGGT
AGGCTCTAGAG -> GGCTCTAGAGT
AGGGAACACTA -> GGGAACACTAT
AGGGACCGAAC -> GGGACCGAACA
AGGGCTCTTCC -> GGGCTCTTCCG
AGGGGCAGCTA -> GGGGCAGCTAA
AGGGGCGCTGG -> GGGGCGCTGGT
AGGTAACGAAT -> GGTAACGAATC
AGGTACAGTTT -> GGTACAGTTTC
AGGTAGTGGCC -> GGTAGTGGCCT
AGGTCACGTCC -> GGTCACGTCCA
AGGTCAGACTC -> GGTCAGACTCT
AGGTCGAACCC -> GGTCGAACCCA
AGGTCGCCTCA -> GGTCGCCTCAG
AGGTGCAGGCA -> GGTGCAGGCAA
AGGTGTCCGAT -> GGTGTCCGATT
AGGTTCGATGA -> GGTTCGATGAC
AGGTTTCGACA -> GGTTTCGACAA
AGTAAAGATAG -> GTAAAGATAGA
AGTAAATGTCC -> GTAAATGTCCG
AGTAATCCCCT -> GTAATCCCCTG
AGTACGATTGG -> GTACGATTGGT
AGTATAACACA -> GTATAACACAC
AGTATACGTTT -> GTATACGTTTA
AGTATTCAGTG -> GTATTCAGTGC
AGTCAATGACT -> GTCAATGACTC
AGTCCAACATC -> GTCCAACATCC
AGTCGCGGGAT -> GTCGCGGGATT
AGTCGGGCCCA -> GTCGGGCCCAG
AGTCTACATAG -> GTCTACATAGG
AGTCTGGGGTA -> GTCTGGGGTAG
AGTCTTCATTG -> GTCTTCATTGT
AGTGCCCCGTC -> GTGCCCCGTCT
AGTGCTGCATA -> GTGCTGCATAA
AGTGGAAGTAC -> GTGGAAGTACG
AGTGGAGCGCG -> GTGGAGCGCGT
AGTGGATTGTC -> GTGGATTGTCG
AGTGGCCTCAG -> GTGGCCTCAGT
AGTGGTCGCCA -> GTGGTCGCCAC
AGTGTTATCTC -> GTGTTATCTCA
AGTTAACAGAA -> GTTAACAGAAG
AGTTCTAAATC -> GTTCTAAATCA
AGTTCTGGACC -> GTTCTGGACCA
AGTTGGAAACC -> GTTGGAAACCT
AGTTGGACCTA -> GTTGGACCTAA
AGTTGGCGTTC -> GTTGGCGTTCA
AGTTGGTGATA -> GTTGGTGATAG
AGTTTAGCGTT -> GTTTAGCGTTG
AGTTTCACTAG -> GTTTCACTAGG
AGTTTCTGGCT -> GTTTCTGGCTG
AGTTTGTAGCG -> GTTTGTAGCGA
ATAAAGCATTG -> TAAAGCATTGC
ATAAAGTGGAA -> TAAAGTGGAAG
ATAACAAACAC -> TAACAAACACT
ATAACACACAA -> TAACACACAAA
ATAACGTACCT -> TAACGTACCTC
ATAAGCACTCA -> TAAGCACTCAC
ATAAGGAAGTA -> TAAGGAAGTAT
ATAAGTTCTAA -> TAAGTTCTAAA
ATAATGTCAGT -> TAATGTCAGTG
ATACATGGATC -> TACATGGATCG
ATACCGGCAGG -> TACCGGCAGGC
ATACGCATCCT -> TACGCATCCTC
ATACGGCATAT -> TACGGCATATC
ATACGGCGGTC -> TACGGCGGTCC
ATACGTACGGT -> TACGTACGGTT
ATACGTTTACA -> TACGTTTACAC
ATACTAGTAAA -> TACTAGTAAAT
ATACTTGGGGC -> TACTTGGGGCC
ATAGACCGGGT -> TAGACCGGGTG
ATAGCCTATTT -> TAGCCTATTTA
ATAGCTAGATG -> TAGCTAGATGA
ATAGCTATCTG -> TAGCTATCTGC
ATAGGCTAATG -> TAGGCTAATGG
ATAGGGACCGA -> TAGGGACCGAA
ATAGGGGCGCT -> TAGGGGCGCTG
ATAGTAAAGAT -> TAGTAAAGATA
ATAGTCTTCAT -> TAGTCTTCATT
ATAGTGTTATC -> TAGTGTTATCT
ATAGTTCTGGA -> TAGTTCTGGAC
ATATAAGCACT -> TATAAGCACTC
ATATCAATTCC -> TATCAATTCCA
ATATTCGGGGC -> TATTCGGGGCA
ATCAAATAACA -> TCAAATAACAA
ATCAAATGGCA -> TCAAATGGCAT
ATCAACTACCA -> TCAACTACCAC
ATCAAGAATCC -> TCAAGAATCCT
ATCAAGCAGCC -> TCAAGCAGCCA
ATCAATTCCAG -> TCAATTCCAGA
ATCAATTTGAA -> TCAATTTGAAG
ATCACTTACTC -> TCACTTACTCA
ATCAGGTCACG -> TCAGGTCACGT
ATCATCAAATA -> TCATCAAATAA
ATCATGGCGCG -> TCATGGCGCGC
ATCATTCCCCT -> TCATTCCCCTA
ATCCAATTCAC -> TCCAATTCACC
ATCCCCAATCT -> TCCCCAATCTA
ATCCCCTGGGA -> TCCCCTGGGAT
ATCCGAATACC -> TCCGAATACCG
ATCCGAATTGC -> TCCGAATTGCT
ATCCTAGGCGC -> TCCTAGGCGCG
ATCCTCGACAT -> TCCTCGACATT
ATCCTCGGCGC -> TCCTCGGCGCG
ATCGAGCACTT -> TCGAGCACTTA
ATCGATAGGCT -> TCGATAGGCTA
ATCGCTATGAA -> TCGCTATGAAG
ATCGGACTGAC -> TCGGACTGACT
ATCGTTCCCCC -> TCGTTCCCCCG
ATCTACAGCTT -> TCTACAGCTTG
ATCTACCTCAA -> TCTACCTCAAT
ATCTCAAACGT -> TCTCAAACGTA
ATCTGCACACG -> TCTGCACACGA
ATCTTCATAGC -> TCTTCATAGCT
ATCTTCCCAAG -> TCTTCCCAAGG
ATCTTTGGGTG -> TCTTTGGGTGA
ATCTTTTGGTA -> TCTTTTGGTAG
ATGAAAAATAT -> TGAAAAATATT
ATGAAGTCGCG -> TGAAGTCGCGG
ATGACCCGACG -> TGACCCGACGA
ATGACGTCCAA -> TGACGTCCAAG
ATGACTCAACG -> TGACTCAACGG
ATGAGACAATC -> TGAGACAATCT
ATGAGACCTTA -> TGAGACCTTAA
ATGAGGGCTCT -> TGAGGGCTCTT
ATGATCTTCAT -> TGATCTTCATA
ATGCACGTGCA -> TGCACGTGCAA
ATGCAGTGGAT -> TGCAGTGGATT
ATGCGCTCTCT -> TGCGCTCTCTC
ATGCTTGATTG -> TGCTTGATTGG
ATGCTTTATTT -> TGCTTTATTTG
ATGGAGCTACG -> TGGAGCTACGA
ATGGATCACTT -> TGGATCACTTA
ATGGATCGCTA -> TGGATCGCTAT
ATGGCACCGCT -> TGGCACCGCTA
ATGGCATGCTT -> TGGCATGCTTT
ATGGCGCGCTG -> TGGCGCGCTGG
ATGGCGTTATG -> TGGCGTTATGT
ATGGGATAGTC -> TGGGATAGTCT
ATGGGTCTTCG -> TGGGTCTTCGG
ATGGGTTACCC -> TGGGTTACCCA
ATGTATTTACC -> TGTATTTACCC
ATGTCAGTGGA -> TGTCAGTGGAG
ATGTCCGATGT -> TGTCCGATGTT
ATGTCTTAGAA -> TGTCTTAGAAT
ATGTGGGTGCA -> TGTGGGTGCAT
ATGTGTGTAGT -> TGTGTGTAGTA
ATGTTATGAGG -> TGTTATGAGGG
ATGTTCAGAAC -> TGTTCAGAACT
ATGTTGCTACG -> TGTTGCTACGC
ATTACCCAGCA -> TTACCCAGCAG
ATTAGACGCTT -> TTAGACGCTTC
ATTAGCGGACG -> TTAGCGGACGA
ATTAGGAAGCT -> TTAGGAAGCTC
ATTAGGTAGTG -> TTAGGTAGTGG
ATTATGAGACA -> TTATGAGACAA
ATTCAAGGAGT -> TTCAAGGAGTT
ATTCAATGTCT -> TTCAATGTCTT
ATTCACCTTGG -> TTCACCTTGGT
ATTCAGCTACC -> TTCAGCTACCG
ATTCAGGTCAG -> TTCAGGTCAGA
ATTCAGTGCTG -> TTCAGTGCTGC
ATTCATTAGCG -> TTCATTAGCGG
ATTCCAGAAAG -> TTCCAGAAAGT
ATTCCCCTAGG -> TTCCCCTAGGT
ATTCGATGCAC -> TTCGATGCACG
ATTCGGGGCAA -> TTCGGGGCAAT
ATTCGTTGGTA -> TTCGTTGGTAG
ATTCTCCGTCT -> TTCTCCGTCTA
ATTGATACTTG -> TTGATACTTGG
ATTGCGGCTGC -> TTGCGGCTGCC
ATTGCTATTCG -> TTGCTATTCGT
ATTGGGATTCA -> TTGGGATTCAA
ATTGGTAGTCC -> TTGGTAGTCCA
ATTGGTGTGAT -> TTGGTGTGATG
ATTGTACTGCT -> TTGTACTGCTT
ATTGTCATTTA -> TTGTCATTTAT
ATTGTCGGAGG -> TTGTCGGAGGT
ATTGTTGCCGC -> TTGTTGCCGCA
ATTTACCCATA -> TTTACCCATAG
ATTTATACGGC -> TTTATACGGCA, TTTATACGGCG
ATTTCATACGC -> TTTCATACGCA
ATTTCGGGAGG -> TTTCGGGAGGT
ATTTGAAGTTT -> TTTGAAGTTTG
ATTTGAATCAA -> TTTGAATCAAT
ATTTTCCTGCT -> TTTTCCTGCTC
CAAAATTGTCA -> AAAATTGTCAT
CAAACACTGCT -> AAACACTGCTG
CAAACAGTGGT -> AAACAGTGGTC
CAAACCCGCCC -> AAACCCGCCCC
CAAACGCTAGC -> AAACGCTAGCC
CAAACGTAATG -> AAACGTAATGC
CAAAGATTTCA -> AAAGATTTCAT
CAAAGCACCAC -> AAAGCACCACT
CAAAGGCCGCA -> AAAGGCCGCAG
CAAATAACAAA -> AAATAACAAAC
CAAATCAGGTC -> AAATCAGGTCA
CAAATGGCATG -> AAATGGCATGC
CAACATAAGGA -> AACATAAGGAA
CAACATCCGAA -> AACATCCGAAT
CAACCGCTTGA -> AACCGCTTGAC
CAACGATGACC -> AACGATGACCC
CAACGGCTGCA -> AACGGCTGCAG
CAACTACCACT -> AACTACCACTG
CAAGAATCCTC -> AAGAATCCTCG
CAAGCAGCCAA -> AAGCAGCCAAT
CAAGCGCCACG -> AAGCGCCACGA
CAAGGAGAGCG -> AAGGAGAGCGG
CAAGGAGTTGG -> AAGGAGTTGGA
CAAGGCTCTAG -> AAGGCTCTAGA
CAAGGTGTCCG -> AAGGTGTCCGA
CAATACATGGA -> AATACATGGAT
CAATAGCCTAT -> AATAGCCTATT
CAATCTACAGC -> AATCTACAGCT
CAATCTACCTC -> AATCTACCTCA
CAATGACTCAA -> AATGACTCAAC
CAATGGCACCG -> AATGGCACCGC
CAATGTCTTAG -> AATGTCTTAGA
CAATTATGAGA -> AATTATGAGAC
CAATTCACCTT -> AATTCACCTTG
CAATTCCAGAA -> AATTCCAGAAA
CAATTCGATGC -> AATTCGATGCA
CAATTGTTGCC -> AATTGTTGCCG
CAATTTGAAGT -> AATTTGAAGTT
CACAAACAGTG -> ACAAACAGTGG
CACAATAGCCT -> ACAATAGCCTA
CACACAAACAG -> ACACAAACAGT
CACACGAAGTT -> ACACGAAGTTT
CACAGCCCCAC -> ACAGCCCCACT
CACAGGCAATT -> ACAGGCAATTC
CACATTCTCCG -> ACATTCTCCGT
CACCACTGAGC -> ACCACTGAGCG
CACCGCTACGC -> ACCGCTACGCG
CACCGTAATTC -> ACCGTAATTCA
CACCTTGGTTT -> ACCTTGGTTTC
CACGAAGTTTA -> ACGAAGTTTAG
CACGAGATCCA -> ACGAGATCCAA
CACGAGCGACA -> ACGAGCGACAA
CACGATGTATT -> ACGATGTATTT
CACGGACCCTC -> ACGGACCCTCG
CACGTCCACAG -> ACGTCCACAGC
CACGTGCAAAC -> ACGTGCAAACG
CACTACGGTTG -> ACTACGGTTGA
CACTAGGTGCA -> ACTAGGTGCAG
CACTATAAGTT -> ACTATAAGTTC
CACTCACCGTA -> ACTCACCGTAA
CACTGAGCGCA -> ACTGAGCGCAA
CACTGATTTTC -> ACTGATTTTCC
CACTGCTGCGG -> ACTGCTGCGGT
CACTGTAACCG -> ACTGTAACCGC
CACTTACAATG -> ACTTACAATGG
CACTTACTCAT -> ACTTACTCATC
CAGAAAGTTGG -> AGAAAGTTGGC
CAGAACTACCT -> AGAACTACCTA
CAGAAGCCGCC -> AGAAGCCGCCT
CAGAATAAAGT -> AGAATAAAGTG
CAGAATAACGT -> AGAATAACGTA
CAGACGGCCTC -> AGACGGCCTCA
CAGACTCTTCG -> AGACTCTTCGA
CAGAGCAGTTA -> AGAGCAGTTAA
CAGCACGGACC -> AGCACGGACCC
CAGCAGCCCCT -> AGCAGCCCCTG
CAGCCAATTAT -> AGCCAATTATG
CAGCCCCACTG -> AGCCCCACTGA
CAGCCCCTGGT -> AGCCCCTGGTT
CAGCGAGAAGG -> AGCGAGAAGGT
CAGCTAAGAGT -> AGCTAAGAGTC
CAGCTACCGAG -> AGCTACCGAGA
CAGCTTAATAG -> AGCTTAATAGT
CAGCTTGAGAC -> AGCTTGAGACC
CAGGCAAAGCA -> AGGCAAAGCAC
CAGGCAAGGTG -> AGGCAAGGTGT
CAGGCAATTCG -> AGGCAATTCGA
CAGGCCGCAAC -> AGGCCGCAACC
CAGGTCACGTC -> AGGTCACGTCC
CAGGTCAGACT -> AGGTCAGACTC
CAGGTCGCCTC -> AGGTCGCCTCA
CAGGTTTCGAC -> AGGTTTCGACA
CAGTATAACAC -> AGTATAACACA
CAGTCAATGAC -> AGTCAATGACT
CAGTGCTGCAT -> AGTGCTGCATA
CAGTGGAGCGC -> AGTGGAGCGCG
CAGTGGATTGT -> AGTGGATTGTC
CAGTGGTCGCC -> AGTGGTCGCCA
CAGTTAACAGA -> AGTTAACAGAA
CAGTTTCACTA -> AGTTTCACTAG
CAGTTTCTGGC -> AGTTTCTGGCT
CATAAGGAAGT -> ATAAGGAAGTA
CATAATGTCAG -> ATAATGTCAGT
CATACGCATCC -> ATACGCATCCT
CATACTAGTAA -> ATACTAGTAAA
CATAGCTATCT -> ATAGCTATCTG
CATAGGGACCG -> ATAGGGACCGA
CATAGGGGCGC -> ATAGGGGCGCT
CATATCAATTC -> ATATCAATTCC
CATCAAATAAC -> ATCAAATAACA
CATCAAATGGC -> ATCAAATGGCA
CATCAACTACC -> ATCAACTACCA
CATCATCAAAT -> ATCATCAAATA
CATCCGAATTG -> ATCCGAATTGC
CATCCTCGACA -> ATCCTCGACAT
CATCTTTGGGT -> ATCTTTGGGTG
CATCTTTTGGT -> ATCTTTTGGTA
CATGAAAAATA -> ATGAAAAATAT
CATGATCTTCA -> ATGATCTTCAT
CATGCAGTGGA -> ATGCAGTGGAT
CATGCTTTATT -> ATGCTTTATTT
CATGGATCACT -> ATGGATCACTT
CATGGATCGCT -> ATGGATCGCTA
CATGGCGCGCT -> ATGGCGCGCTG
CATGTTATGAG -> ATGTTATGAGG
CATGTTGCTAC -> ATGTTGCTACG
CATTAGCGGAC -> ATTAGCGGACG
CATTCAAGGAG -> ATTCAAGGAGT
CATTCCCCTAG -> ATTCCCCTAGG
CATTCTCCGTC -> ATTCTCCGTCT
CATTGATACTT -> ATTGATACTTG
CATTGCGGCTG -> ATTGCGGCTGC
CATTGTACTGC -> ATTGTACTGCT
CATTTATACGG -> ATTTATACGGC
CCAAAATTGTC -> CAAAATTGTCA
CCAAATCAGGT -> CAAATCAGGTC
CCAACATCCGA -> CAACATCCGAA
CCAAGCGCCAC -> CAAGCGCCACG
CCAAGGCTCTA -> CAAGGCTCTAG
CCAATCTACAG -> CAATCTACAGC
CCAATTATGAG -> CAATTATGAGA
CCAATTCACCT -> CAATTCACCTT
CCACAGCCCCA -> CACAGCCCCAC
CCACAGGCAAT -> CACAGGCAATT
CCACGAGCGAC -> CACGAGCGACA
CCACGATGTAT -> CACGATGTATT
CCACTGAGCGC -> CACTGAGCGCA
CCACTGATTTT -> CACTGATTTTC
CCACTGTAACC -> CACTGTAACCG
CCAGAAAGTTG -> CAGAAAGTTGG
CCAGAATAACG -> CAGAATAACGT
CCAGACGGCCT -> CAGACGGCCTC
CCAGCAGCCCC -> CAGCAGCCCCT
CCAGGCAAAGC -> CAGGCAAAGCA
CCAGTATAACA -> CAGTATAACAC
CCATAGGGACC -> CATAGGGACCG
CCATCAAATGG -> CATCAAATGGC
CCATCTTTTGG -> CATCTTTTGGT
CCATGCAGTGG -> CATGCAGTGGA
CCATGTTATGA -> CATGTTATGAG
CCCAAGGCTCT -> CCAAGGCTCTA
CCCAATCTACA -> CCAATCTACAG
CCCACTGATTT -> CCACTGATTTT
CCCAGAATAAC -> CCAGAATAACG
CCCAGACGGCC -> CCAGACGGCCT
CCCAGCAGCCC -> CCAGCAGCCCC
CCCAGGCAAAG -> CCAGGCAAAGC
CCCATAGGGAC -> CCATAGGGACC
CCCATCTTTTG -> CCATCTTTTGG
CCCATGCAGTG -> CCATGCAGTGG
CCCCAATCTAC -> CCCAATCTACA
CCCCACTGATT -> CCCACTGATTT
CCCCCGGATTG -> CCCCGGATTGG
CCCCGGATTGG -> CCCGGATTGGT
CCCCGTCTATC -> CCCGTCTATCG
CCCCTAGGTAA -> CCCTAGGTAAC
CCCCTCACTAC -> CCCTCACTACG
CCCCTGGGATC -> CCCTGGGATCC
CCCCTGGTTAT -> CCCTGGTTATC
CCCCTTGCTGC -> CCCTTGCTGCT
CCCGACGATTT -> CCGACGATTTC
CCCGCCCCTCA -> CCGCCCCTCAC
CCCGGATTGGT -> CCGGATTGGTA
CCCGTCTATCG -> CCGTCTATCGT
CCCGTCTTTGC -> CCGTCTTTGCC
CCCTAGGTAAC -> CCTAGGTAACG
CCCTCACTACG -> CCTCACTACGG
CCCTCCTCTTT -> CCTCCTCTTTG
CCCTCGTGTGT -> CCTCGTGTGTA
CCCTGGGATCC -> CCTGGGATCCT
CCCTGGTTATC -> CCTGGTTATCG
CCCTTCTATGG -> CCTTCTATGGG
CCCTTGCTGCT -> CCTTGCTGCTC
CCGAACATGAT -> CGAACATGATC
CCGAATACCGG -> CGAATACCGGC
CCGAATCATTC -> CGAATCATTCC
CCGAATTGCTA -> CGAATTGCTAT
CCGACCGGATT -> CGACCGGATTA
CCGACGATTTC -> CGACGATTTCG
CCGAGAACGCT -> CGAGAACGCTA
CCGATGTTCAG -> CGATGTTCAGA
CCGATTACCCA -> CGATTACCCAG
CCGCAAAGGCC -> CGCAAAGGCCG
CCGCAACCGCT -> CGCAACCGCTT
CCGCAGTCAAT -> CGCAGTCAATG
CCGCATACTAG -> CGCATACTAGT
CCGCCCCTCAC -> CGCCCCTCACT
CCGCCTAGATA -> CGCCTAGATAT
CCGCCTCGCAG -> CGCCTCGCAGC
CCGCTACGCGA -> CGCTACGCGAC
CCGCTTCGAGC -> CGCTTCGAGCA
CCGCTTGACAA -> CGCTTGACAAG
CCGGATTAGGT -> CGGATTAGGTA
CCGGATTGGTA -> CGGATTGGTAG
CCGGCAGGCCG -> CGGCAGGCCGC
CCGGCTATCTT -> CGGCTATCTTC
CCGGGTGTCCC -> CGGGTGTCCCT
CCGGTAGTTGG -> CGGTAGTTGGT
CCGTAATTCAG -> CGTAATTCAGG
CCGTAGAATAG -> CGTAGAATAGT
CCGTCTATCAT -> CGTCTATCATG
CCGTCTATCGT -> CGTCTATCGTT
CCGTCTGAAAC -> CGTCTGAAACC
CCGTCTTTGCC -> CGTCTTTGCCT
CCGTGACCCTC -> CGTGACCCTCC
CCGTGTGTCGA -> CGTGTGTCGAT
CCTAACAGGTC -> CTAACAGGTCG
CCTACCCAGAC -> CTACCCAGACG
CCTACCGTAGA -> CTACCGTAGAA
CCTAGATATAA -> CTAGATATAAG
CCTAGCATCAA -> CTAGCATCAAC
CCTAGGCGCGG -> CTAGGCGCGGA
CCTAGGTAACG -> CTAGGTAACGA
CCTATTTATAC -> CTATTTATACG
CCTCAATTGTT -> CTCAATTGTTG
CCTCACTACGG -> CTCACTACGGT
CCTCAGAATAA -> CTCAGAATAAA
CCTCAGAGCAG -> CTCAGAGCAGT
CCTCAGTTTCT -> CTCAGTTTCTG
CCTCCAGTATA -> CTCCAGTATAA
CCTCCTCTTTG -> CTCCTCTTTGC
CCTCGACATTG -> CTCGACATTGA
CCTCGATGGGA -> CTCGATGGGAT
CCTCGCAGCGA -> CTCGCAGCGAG
CCTCGCTCGAA -> CTCGCTCGAAC
CCTCGGCGCGC -> CTCGGCGCGCC
CCTCGTGTGTA -> CTCGTGTGTAC
CCTCTCTGAAG -> CTCTCTGAAGG
CCTCTTAATTA -> CTCTTAATTAG
CCTCTTTGCTG -> CTCTTTGCTGG
CCTGCAACGAT -> CTGCAACGATG
CCTGCACAATA -> CTGCACAATAG
CCTGCTCCTCT -> CTGCTCCTCTT
CCTGGGATCCT -> CTGGGATCCTA
CCTGGTTATCG -> CTGGTTATCGA
CCTTAACGCCG -> CTTAACGCCGC
CCTTATGGAGC -> CTTATGGAGCT
CCTTCTATGGG -> CTTCTATGGGT
CCTTGCTGCTC -> CTTGCTGCTCG
CCTTGGTTTCA -> CTTGGTTTCAT
CGAAATGGCGT -> GAAATGGCGTT
CGAACATGATC -> GAACATGATCT
CGAACCCATCT -> GAACCCATCTT
CGAACGAAGTC -> GAACGAAGTCG
CGAAGGATAGT -> GAAGGATAGTG
CGAAGTCGGGC -> GAAGTCGGGCC
CGAAGTTTAGC -> GAAGTTTAGCG
CGAATACCGGC -> GAATACCGGCA
CGAATCAAGCA -> GAATCAAGCAG
CGAATCATTCC -> GAATCATTCCC
CGAATTGCTAT -> GAATTGCTATT
CGACAAAGATT -> GACAAAGATTT
CGACAACATAA -> GACAACATAAG
CGACATGAAAA -> GACATGAAAAA
CGACATTGATA -> GACATTGATAC
CGACCGGATTA -> GACCGGATTAG
CGACCTCTCTG -> GACCTCTCTGA
CGACGATTTCG -> GACGATTTCGG
CGAGAACGCTA -> GAGAACGCTAG
CGAGAAGGTTC -> GAGAAGGTTCG
CGAGATCCAAT -> GAGATCCAATT
CGAGCACTTAC -> GAGCACTTACA
CGAGCAGGTTT -> GAGCAGGTTTC
CGAGCGACAAC -> GAGCGACAACA
CGAGTGCCCCG -> GAGTGCCCCGT
CGATAGGCTAA -> GATAGGCTAAT
CGATCCCCAAT -> GATCCCCAATC
CGATCCGAATA -> GATCCGAATAC
CGATGACCCGA -> GATGACCCGAC
CGATGACGTCC -> GATGACGTCCA
CGATGCACGTG -> GATGCACGTGC
CGATGCGCTCT -> GATGCGCTCTC
CGATGGGATAG -> GATGGGATAGT
CGATGTATTTA -> GATGTATTTAC
CGATGTTCAGA -> GATGTTCAGAA
CGATTACCCAG -> GATTACCCAGC
CGATTGGTGTG -> GATTGGTGTGA
CGATTTCGGGA -> GATTTCGGGAG
CGCAAACCCGC -> GCAAACCCGCC
CGCAAAGGCCG -> GCAAAGGCCGC
CGCAACCGCTT -> GCAACCGCTTG
CGCAGCGAGAA -> GCAGCGAGAAG
CGCAGTCAATG -> GCAGTCAATGA
CGCATACTAGT -> GCATACTAGTA
CGCATCCTCGA -> GCATCCTCGAC
CGCATTCAAGG -> GCATTCAAGGA
CGCCACAGGCA -> GCCACAGGCAA
CGCCACGAGCG -> GCCACGAGCGA
CGCCATGTTAT -> GCCATGTTATG
CGCCCCTCACT -> GCCCCTCACTA
CGCCCGTCTTT -> GCCCGTCTTTG
CGCCGCTTCGA -> GCCGCTTCGAG
CGCCTAGATAT -> GCCTAGATATA
CGCCTCAGAAT -> GCCTCAGAATA
CGCCTCGCAGC -> GCCTCGCAGCG
CGCGACCTCTC -> GCGACCTCTCT
CGCGATCCGAA -> GCGATCCGAAT
CGCGCCCGTCT -> GCGCCCGTCTT
CGCGCTGGGTA -> GCGCTGGGTAT
CGCGGACATGG -> GCGGACATGGA
CGCGGGATTCA -> GCGGGATTCAG
CGCGTACGTAC -> GCGTACGTACC
CGCTACGCGAC -> GCTACGCGACC
CGCTAGCACAT -> GCTAGCACATT
CGCTAGCCGTG -> GCTAGCCGTGA
CGCTATGAAGT -> GCTATGAAGTC
CGCTCGAACGA -> GCTCGAACGAA
CGCTCTCTCCG -> GCTCTCTCCGG
CGCTGGGTATC -> GCTGGGTATCG
CGCTGGTCGTG -> GCTGGTCGTGC
CGCTTCCAAAA -> GCTTCCAAAAT
CGCTTCGAGCA -> GCTTCGAGCAG
CGCTTGACAAG -> GCTTGACAAGG
CGGACATGGAT -> GGACATGGATC
CGGACCCTCGT -> GGACCCTCGTG
CGGACGATCCC -> GGACGATCCCC
CGGACTGACTA -> GGACTGACTAG
CGGAGGTCGAA -> GGAGGTCGAAC
CGGATTAGGTA -> GGATTAGGTAG
CGGATTGGTAG -> GGATTGGTAGT
CGGCAGGCCGC -> GGCAGGCCGCA
CGGCATATCAA -> GGCATATCAAT
CGGCCTCAGAG -> GGCCTCAGAGC
CGGCGCGCCCG -> GGCGCGCCCGT
CGGCGGTCCTC -> GGCGGTCCTCG
CGGCTATCTTC -> GGCTATCTTCC
CGGCTCCGCAT -> GGCTCCGCATA
CGGCTGCAGCA -> GGCTGCAGCAC
CGGCTGCCTGC -> GGCTGCCTGCA
CGGGAGGTACA -> GGGAGGTACAG
CGGGATTCAGC -> GGGATTCAGCT
CGGGCCCAGAA -> GGGCCCAGAAT
CGGGCCTTATG -> GGGCCTTATGG
CGGGGCAATAC -> GGGGCAATACA
CGGGTGTCCCT -> GGGTGTCCCTT
CGGTAGTTGGT -> GGTAGTTGGTG
CGGTCCTCGCT -> GGTCCTCGCTC
CGGTGTATCGA -> GGTGTATCGAT
CGGTTAGGCCG -> GGTTAGGCCGG
CGGTTGAAGAT -> GGTTGAAGATA
CGTAATGCTTG -> GTAATGCTTGA
CGTAATTCAGG -> GTAATTCAGGT
CGTACCGTCTG -> GTACCGTCTGA
CGTACCTCCAG -> GTACCTCCAGT
CGTACGGTTAG -> GTACGGTTAGG
CGTACGTACCG -> GTACGTACCGT
CGTAGAATAGT -> GTAGAATAGTA
CGTCCAAGCGC -> GTCCAAGCGCC
CGTCCACAGCC -> GTCCACAGCCC
CGTCGAAGGAT -> GTCGAAGGATA
CGTCTATCATG -> GTCTATCATGG
CGTCTATCGTT -> GTCTATCGTTC
CGTCTGAAACC -> GTCTGAAACCT
CGTCTTTGCCT -> GTCTTTGCCTA
CGTGACCCTCC -> GTGACCCTCCT
CGTGCAAACGC -> GTGCAAACGCT
CGTGCCGACCG -> GTGCCGACCGG
CGTGCGTGCCG -> GTGCGTGCCGA
CGTGTGTACCT -> GTGTGTACCTC
CGTGTGTCGAT -> GTGTGTCGATG
CGTTCAGCTTA -> GTTCAGCTTAA
CGTTCCCCCGG -> GTTCCCCCGGA
CGTTGATTCAT -> GTTGATTCATT
CGTTGGTAGGG -> GTTGGTAGGGG
CGTTTACACGA -> GTTTACACGAG
CTAAATCAAGA -> TAAATCAAGAA
CTAACAGGTCG -> TAACAGGTCGC
CTAAGAGTCTG -> TAAGAGTCTGG
CTAATGGGTCT -> TAATGGGTCTT
CTACAGCTTGA -> TACAGCTTGAG
CTACATAGGGG -> TACATAGGGGC
CTACCACTGTA -> TACCACTGTAA
CTACCCAGACG -> TACCCAGACGG
CTACCGAGAAC -> TACCGAGAACG
CTACCGTAGAA -> TACCGTAGAAT
CTACCTACCGT -> TACCTACCGTA
CTACCTCAATT -> TACCTCAATTG
CTACGAGTGCC -> TACGAGTGCCC
CTACGCGACCT -> TACGCGACCTC
CTACGCGATCC -> TACGCGATCCG
CTACGGTTGAA -> TACGGTTGAAG
CTAGAGTCTAC -> TAGAGTCTACA
CTAGATATAAG -> TAGATATAAGC
CTAGATGAGAC -> TAGATGAGACC
CTAGCACATTC -> TAGCACATTCT
CTAGCATCAAC -> TAGCATCAACT
CTAGCCGTGAC -> TAGCCGTGACC
CTAGGCGCGGA -> TAGGCGCGGAC
CTAGGTAACGA -> TAGGTAACGAA
CTAGGTGCAGG -> TAGGTGCAGGC
CTAGTAAATGT -> TAGTAAATGTC
CTAGTTGGACC -> TAGTTGGACCT
CTATAAGTTCT -> TATAAGTTCTA
CTATCATGGCG -> TATCATGGCGC
CTATCGTTCCC -> TATCGTTCCCC
CTATCTGCACA -> TATCTGCACAC
CTATCTTCCCA -> TATCTTCCCAA
CTATGAAGTCG -> TATGAAGTCGC
CTATGGGTTAC -> TATGGGTTACC
CTATTCGTTGG -> TATTCGTTGGT
CTATTTATACG -> TATTTATACGG
CTCAAACGTAA -> TCAAACGTAAT
CTCAACGGCTG -> TCAACGGCTGC
CTCAATTGTTG -> TCAATTGTTGC
CTCACCGTAAT -> TCACCGTAATT
CTCACTACGGT -> TCACTACGGTT
CTCAGAATAAA -> TCAGAATAAAG
CTCAGAGCAGT -> TCAGAGCAGTT
CTCAGTTTCTG -> TCAGTTTCTGG
CTCATCATCAA -> TCATCATCAAA
CTCCACGATGT -> TCCACGATGTA
CTCCAGTATAA -> TCCAGTATAAC
CTCCGAATCAT -> TCCGAATCATT
CTCCGCATACT -> TCCGCATACTA
CTCCGGTAGTT -> TCCGGTAGTTG
CTCCGTCTATC -> TCCGTCTATCA
CTCCTCTTAAT -> TCCTCTTAATT
CTCCTCTTTGC -> TCCTCTTTGCT
CTCGAACGAAG -> TCGAACGAAGT
CTCGACATTGA -> TCGACATTGAT
CTCGATGGGAT -> TCGATGGGATA
CTCGCAGCGAG -> TCGCAGCGAGA
CTCGCTCGAAC -> TCGCTCGAACG
CTCGGCGCGCC -> TCGGCGCGCCC
CTCGTCGAAGG -> TCGTCGAAGGA
CTCGTGTGTAC -> TCGTGTGTACC
CTCTAGAGTCT -> TCTAGAGTCTA
CTCTCCGGTAG -> TCTCCGGTAGT
CTCTCTCCGGT -> TCTCTCCGGTA
CTCTCTGAAGG -> TCTCTGAAGGG
CTCTGAAGGGA -> TCTGAAGGGAA
CTCTTAATTAG -> TCTTAATTAGG
CTCTTCCGTGT -> TCTTCCGTGTG
CTCTTCGAAAT -> TCTTCGAAATG
CTCTTTGCTGG -> TCTTTGCTGGT
CTGAAACCTGC -> TGAAACCTGCA
CTGAAGGGAAC -> TGAAGGGAACA
CTGACTAGTTG -> TGACTAGTTGG
CTGAGATGTGT -> TGAGATGTGTG
CTGAGCGCAAA -> TGAGCGCAAAC
CTGATTTTCCT -> TGATTTTCCTG
CTGCAACGATG -> TGCAACGATGA
CTGCACAATAG -> TGCACAATAGC
CTGCACACGAA -> TGCACACGAAG
CTGCAGCACGG -> TGCAGCACGGA
CTGCATAATGT -> TGCATAATGTC
CTGCCTGCACA -> TGCCTGCACAA
CTGCGGTGTAT -> TGCGGTGTATC
CTGCTCCTCTT -> TGCTCCTCTTA
CTGCTCGTCGA -> TGCTCGTCGAA
CTGCTGCGGTG -> TGCTGCGGTGT
CTGCTTACTCC -> TGCTTACTCCA
CTGGACCATCA -> TGGACCATCAA
CTGGCTGAGAT -> TGGCTGAGATG
CTGGGATCCTA -> TGGGATCCTAG
CTGGGGTAGCG -> TGGGGTAGCGC
CTGGGTATCGG -> TGGGTATCGGA
CTGGTCCAAAT -> TGGTCCAAATC
CTGGTCGTGCG -> TGGTCGTGCGT
CTGGTTATCGA -> TGGTTATCGAG
CTGTAACCGCC -> TGTAACCGCCT
CTTAACGCCGC -> TTAACGCCGCT
CTTAATAGTTC -> TTAATAGTTCT
CTTAATTAGGA -> TTAATTAGGAA
CTTACAATGGC -> TTACAATGGCA
CTTACTCATCA -> TTACTCATCAT
CTTACTCCACG -> TTACTCCACGA
CTTAGAATACG -> TTAGAATACGT
CTTATGGAGCT -> TTATGGAGCTA
CTTCATAGCTA -> TTCATAGCTAT
CTTCATTGTAC -> TTCATTGTACT
CTTCCAAAATT -> TTCCAAAATTG
CTTCCCAAGGC -> TTCCCAAGGCT
CTTCCGTGTGT -> TTCCGTGTGTC
CTTCGAAATGG -> TTCGAAATGGC
CTTCGAGCAGG -> TTCGAGCAGGT
CTTCGGCTCCG -> TTCGGCTCCGC
CTTCTATGGGT -> TTCTATGGGTT
CTTGACAAGGA -> TTGACAAGGAG
CTTGAGACCCA -> TTGAGACCCAT
CTTGATTGGGA -> TTGATTGGGAT
CTTGCTGCTCG -> TTGCTGCTCGT
CTTGGGGCCCC -> TTGGGGCCCCT
CTTGGTTTCAT -> TTGGTTTCATC
CTTTATTTGAA -> TTTATTTGAAT
CTTTGCCTACC -> TTTGCCTACCC
CTTTGCTGGTC -> TTTGCTGGTCC
CTTTGGGTGAT -> TTTGGGTGATT
CTTTTGGTAGT -> TTTTGGTAGTA
GAAAAATATTC -> AAAAATATTCG
GAAACCTAGCA -> AAACCTAGCAT
GAAACCTGCAA -> AAACCTGCAAC
GAAAGTTGGCG -> AAAGTTGGCGT
GAAATGGCGTT -> AAATGGCGTTA
GAACACTATAA -> AACACTATAAG
GAACATGATCT -> AACATGATCTT
GAACCCATCTT -> AACCCATCTTT
GAACGAAGTCG -> AACGAAGTCGG
GAACGCTAGCA -> AACGCTAGCAC
GAACTACCTAC -> AACTACCTACC
GAAGATAAAGC -> AAGATAAAGCA
GAAGCCGCCTA -> AAGCCGCCTAG
GAAGCTCCGAA -> AAGCTCCGAAT
GAAGGATAGTG -> AAGGATAGTGT
GAAGGGAACAC -> AAGGGAACACT
GAAGGTTCGAT -> AAGGTTCGATG
GAAGTACGATT -> AAGTACGATTG
GAAGTATTCAG -> AAGTATTCAGT
GAAGTCGCGGG -> AAGTCGCGGGA
GAAGTCGGGCC -> AAGTCGGGCCC
GAAGTTTAGCG -> AAGTTTAGCGT
GAAGTTTGTAG -> AAGTTTGTAGC
GAATAAAGTGG -> AATAAAGTGGA
GAATAACGTAC -> AATAACGTACC
GAATACCGGCA -> AATACCGGCAG
GAATACGTACG -> AATACGTACGG
GAATAGTAAAG -> AATAGTAAAGA
GAATCAAGCAG -> AATCAAGCAGC
GAATCAATTTG -> AATCAATTTGA
GAATCATTCCC -> AATCATTCCCC
GAATCCTCGGC -> AATCCTCGGCG
GAATTGCTATT -> AATTGCTATTC
GACAAAGATTT -> ACAAAGATTTC
GACAACATAAG -> ACAACATAAGG
GACAAGGAGAG -> ACAAGGAGAGC
GACAATCTACC -> ACAATCTACCT
GACATGAAAAA -> ACATGAAAAAT
GACATGGATCA -> ACATGGATCAC
GACATTGATAC -> ACATTGATACT
GACCATCAAAT -> ACCATCAAATG
GACCCATGCAG -> ACCCATGCAGT
GACCCGACGAT -> ACCCGACGATT
GACCCTCCTCT -> ACCCTCCTCTT
GACCCTCGTGT -> ACCCTCGTGTG
GACCGAACATG -> ACCGAACATGA
GACCGGATTAG -> ACCGGATTAGG
GACCGGGTGTC -> ACCGGGTGTCC
GACCTAACAGG -> ACCTAACAGGT
GACCTCTCTGA -> ACCTCTCTGAA
GACCTTAACGC -> ACCTTAACGCC
GACGATCCCCA -> ACGATCCCCAA
GACGATTTCGG -> ACGATTTCGGG
GACGCTTCCAA -> ACGCTTCCAAA
GACGGCCTCAG -> ACGGCCTCAGA
GACGTCCAAGC -> ACGTCCAAGCG
GACTAGTTGGA -> ACTAGTTGGAC
GACTCAACGGC -> ACTCAACGGCT
GACTCTTCGAA -> ACTCTTCGAAA
GACTGACTAGT -> ACTGACTAGTT
GAGAACGCTAG -> AGAACGCTAGC
GAGAAGGTTCG -> AGAAGGTTCGA
GAGACAATCTA -> AGACAATCTAC
GAGACCCATGC -> AGACCCATGCA
GAGACCTTAAC -> AGACCTTAACG
GAGAGCGGGCC -> AGAGCGGGCCT
GAGATCCAATT -> AGATCCAATTC
GAGATGTGTGT -> AGATGTGTGTA
GAGCACTTACA -> AGCACTTACAA
GAGCAGGTTTC -> AGCAGGTTTCG
GAGCAGTTAAC -> AGCAGTTAACA
GAGCGACAACA -> AGCGACAACAT
GAGCGCAAACC -> AGCGCAAACCC
GAGCGCGTACG -> AGCGCGTACGT
GAGCGGGCCTT -> AGCGGGCCTTA
GAGCTACGAGT -> AGCTACGAGTG
GAGGGCTCTTC -> AGGGCTCTTCC
GAGGTACAGTT -> AGGTACAGTTT
GAGGTCGAACC -> AGGTCGAACCC
GAGTCTACATA -> AGTCTACATAG
GAGTCTGGGGT -> AGTCTGGGGTA
GAGTGCCCCGT -> AGTGCCCCGTC
GAGTTGGAAAC -> AGTTGGAAACC
GATAAAGCATT -> ATAAAGCATTG
GATACTTGGGG -> ATACTTGGGGC
GATAGACCGGG -> ATAGACCGGGT
GATAGCTAGAT -> ATAGCTAGATG
GATAGGCTAAT -> ATAGGCTAATG
GATAGTCTTCA -> ATAGTCTTCAT
GATAGTGTTAT -> ATAGTGTTATC
GATATAAGCAC -> ATATAAGCACT
GATCACTTACT -> ATCACTTACTC
GATCCAATTCA -> ATCCAATTCAC
GATCCCCAATC -> ATCCCCAATCT
GATCCGAATAC -> ATCCGAATACC
GATCCTAGGCG -> ATCCTAGGCGC
GATCGCTATGA -> ATCGCTATGAA
GATCTTCATAG -> ATCTTCATAGC
GATGACCCGAC -> ATGACCCGACG
GATGACGTCCA -> ATGACGTCCAA
GATGAGACCTT -> ATGAGACCTTA
GATGCACGTGC -> ATGCACGTGCA
GATGCGCTCTC -> ATGCGCTCTCT
GATGGGATAGT -> ATGGGATAGTC
GATGTATTTAC -> ATGTATTTACC
GATGTGGGTGC -> ATGTGGGTGCA
GATGTGTGTAG -> ATGTGTGTAGT
GATGTTCAGAA -> ATGTTCAGAAC
GATTACCCAGC -> ATTACCCAGCA
GATTAGACGCT -> ATTAGACGCTT
GATTAGGTAGT -> ATTAGGTAGTG
GATTCAATGTC -> ATTCAATGTCT
GATTCAGCTAC -> ATTCAGCTACC
GATTCATTAGC -> ATTCATTAGCG
GATTGGGATTC -> ATTGGGATTCA
GATTGGTAGTC -> ATTGGTAGTCC
GATTGGTGTGA -> ATTGGTGTGAT
GATTGTCGGAG -> ATTGTCGGAGG
GATTTCATACG -> ATTTCATACGC
GATTTCGGGAG -> ATTTCGGGAGG
GATTTTCCTGC -> ATTTTCCTGCT
GCAAACCCGCC -> CAAACCCGCCC
GCAAACGCTAG -> CAAACGCTAGC
GCAAAGCACCA -> CAAAGCACCAC
GCAAAGGCCGC -> CAAAGGCCGCA
GCAACCGCTTG -> CAACCGCTTGA
GCAACGATGAC -> CAACGATGACC
GCAAGGTGTCC -> CAAGGTGTCCG
GCAATACATGG -> CAATACATGGA
GCAATTCGATG -> CAATTCGATGC
GCACAATAGCC -> CACAATAGCCT
GCACACGAAGT -> CACACGAAGTT
GCACATTCTCC -> CACATTCTCCG
GCACCACTGAG -> CACCACTGAGC
GCACCGCTACG -> CACCGCTACGC
GCACGGACCCT -> CACGGACCCTC
GCACGTGCAAA -> CACGTGCAAAC
GCACTCACCGT -> CACTCACCGTA
GCACTTACAAT -> CACTTACAATG
GCAGCACGGAC -> CAGCACGGACC
GCAGCCAATTA -> CAGCCAATTAT
GCAGCCCCTGG -> CAGCCCCTGGT
GCAGCGAGAAG -> CAGCGAGAAGG
GCAGCTAAGAG -> CAGCTAAGAGT
GCAGGCAAGGT -> CAGGCAAGGTG
GCAGGCCGCAA -> CAGGCCGCAAC
GCAGGTTTCGA -> CAGGTTTCGAC
GCAGTCAATGA -> CAGTCAATGAC
GCAGTGGATTG -> CAGTGGATTGT
GCAGTTAACAG -> CAGTTAACAGA
GCATAATGTCA -> CATAATGTCAG
GCATACTAGTA -> CATACTAGTAA
GCATATCAATT -> CATATCAATTC
GCATCAACTAC -> CATCAACTACC
GCATCCTCGAC -> CATCCTCGACA
GCATGCTTTAT -> CATGCTTTATT
GCATGTTGCTA -> CATGTTGCTAC
GCATTCAAGGA -> CATTCAAGGAG
GCATTGCGGCT -> CATTGCGGCTG
GCCAATTATGA -> CCAATTATGAG
GCCACAGGCAA -> CCACAGGCAAT
GCCACGAGCGA -> CCACGAGCGAC
GCCATGTTATG -> CCATGTTATGA
GCCCAGAATAA -> CCCAGAATAAC
GCCCCACTGAT -> CCCCACTGATT
GCCCCGTCTAT -> CCCCGTCTATC
GCCCCTCACTA -> CCCCTCACTAC
GCCCCTGGTTA -> CCCCTGGTTAT
GCCCCTTGCTG -> CCCCTTGCTGC
GCCCGTCTTTG -> CCCGTCTTTGC
GCCGACCGGAT -> CCGACCGGATT
GCCGCAAAGGC -> CCGCAAAGGCC
GCCGCAACCGC -> CCGCAACCGCT
GCCGCAGTCAA -> CCGCAGTCAAT
GCCGCCTAGAT -> CCGCCTAGATA
GCCGCTTCGAG -> CCGCTTCGAGC
GCCGGCTATCT -> CCGGCTATCTT
GCCGTGACCCT -> CCGTGACCCTC
GCCTACCCAGA -> CCTACCCAGAC
GCCTAGATATA -> CCTAGATATAA
GCCTATTTATA -> CCTATTTATAC
GCCTCAGAATA -> CCTCAGAATAA
GCCTCAGAGCA -> CCTCAGAGCAG
GCCTCAGTTTC -> CCTCAGTTTCT
GCCTCGCAGCG -> CCTCGCAGCGA
GCCTGCACAAT -> CCTGCACAATA
GCCTTATGGAG -> CCTTATGGAGC
GCGACAACATA -> CGACAACATAA
GCGACATGAAA -> CGACATGAAAA
GCGACCTCTCT -> CGACCTCTCTG
GCGAGAAGGTT -> CGAGAAGGTTC
GCGATCCGAAT -> CGATCCGAATA
GCGCAAACCCG -> CGCAAACCCGC
GCGCATTCAAG -> CGCATTCAAGG
GCGCCACGAGC -> CGCCACGAGCG
GCGCCCGTCTT -> CGCCCGTCTTT
GCGCGCCCGTC -> CGCGCCCGTCT
GCGCGCTGGGT -> CGCGCTGGGTA
GCGCGGACATG -> CGCGGACATGG
GCGCGTACGTA -> CGCGTACGTAC
GCGCTCTCTCC -> CGCTCTCTCCG
GCGCTGGGTAT -> CGCTGGGTATC
GCGCTGGTCGT -> CGCTGGTCGTG
GCGGACATGGA -> CGGACATGGAT
GCGGACGATCC -> CGGACGATCCC
GCGGCTGCCTG -> CGGCTGCCTGC
GCGGGATTCAG -> CGGGATTCAGC
GCGGGCCTTAT -> CGGGCCTTATG
GCGGTCCTCGC -> CGGTCCTCGCT
GCGGTGTATCG -> CGGTGTATCGA
GCGTACGTACC -> CGTACGTACCG
GCGTGCCGACC -> CGTGCCGACCG
GCGTTATGTCC -> CGTTATGTCCC
GCGTTCAGCTT -> CGTTCAGCTTA
GCGTTGATTCA -> CGTTGATTCAT
GCTAAGAGTCT -> CTAAGAGTCTG
GCTAATGGGTC -> CTAATGGGTCT
GCTACCGAGAA -> CTACCGAGAAC
GCTACGAGTGC -> CTACGAGTGCC
GCTACGCGACC -> CTACGCGACCT
GCTACGCGATC -> CTACGCGATCC
GCTAGATGAGA -> CTAGATGAGAC
GCTAGCACATT -> CTAGCACATTC
GCTAGCCGTGA -> CTAGCCGTGAC
GCTATCTGCAC -> CTATCTGCACA
GCTATCTTCCC -> CTATCTTCCCA
GCTATGAAGTC -> CTATGAAGTCG
GCTATTCGTTG -> CTATTCGTTGG
GCTCCGAATCA -> CTCCGAATCAT
GCTCCGCATAC -> CTCCGCATACT
GCTCCTCTTAA -> CTCCTCTTAAT
GCTCGAACGAA -> CTCGAACGAAG
GCTCGTCGAAG -> CTCGTCGAAGG
GCTCTAGAGTC -> CTCTAGAGTCT
GCTCTCTCCGG -> CTCTCTCCGGT
GCTCTTCCGTG -> CTCTTCCGTGT
GCTGAGATGTG -> CTGAGATGTGT
GCTGCAGCACG -> CTGCAGCACGG
GCTGCATAATG -> CTGCATAATGT
GCTGCCTGCAC -> CTGCCTGCACA
GCTGCGGTGTA -> CTGCGGTGTAT
GCTGCTCGTCG -> CTGCTCGTCGA
GCTGGGTATCG -> CTGGGTATCGG
GCTGGTCCAAA -> CTGGTCCAAAT
GCTGGTCGTGC -> CTGGTCGTGCG
GCTTAATAGTT -> CTTAATAGTTC
GCTTACTCCAC -> CTTACTCCACG
GCTTCCAAAAT -> CTTCCAAAATT
GCTTCGAGCAG -> CTTCGAGCAGG
GCTTGACAAGG -> CTTGACAAGGA
GCTTGAGACCC -> CTTGAGACCCA
GCTTGATTGGG -> CTTGATTGGGA
GCTTTATTTGA -> CTTTATTTGAA
GGAAACCTAGC -> GAAACCTAGCA
GGAACACTATA -> GAACACTATAA
GGAAGCTCCGA -> GAAGCTCCGAA
GGAAGTACGAT -> GAAGTACGATT
GGAAGTATTCA -> GAAGTATTCAG
GGACATGGATC -> GACATGGATCA
GGACCATCAAA -> GACCATCAAAT
GGACCCTCGTG -> GACCCTCGTGT
GGACCGAACAT -> GACCGAACATG
GGACCTAACAG -> GACCTAACAGG
GGACGATCCCC -> GACGATCCCCA
GGACTGACTAG -> GACTGACTAGT
GGAGAGCGGGC -> GAGAGCGGGCC
GGAGCGCGTAC -> GAGCGCGTACG
GGAGCTACGAG -> GAGCTACGAGT
GGAGGTACAGT -> GAGGTACAGTT
GGAGGTCGAAC -> GAGGTCGAACC
GGAGTTGGAAA -> GAGTTGGAAAC
GGATAGTCTTC -> GATAGTCTTCA
GGATAGTGTTA -> GATAGTGTTAT
GGATCACTTAC -> GATCACTTACT
GGATCCTAGGC -> GATCCTAGGCG
GGATCGCTATG -> GATCGCTATGA
GGATTAGGTAG -> GATTAGGTAGT
GGATTCAATGT -> GATTCAATGTC
GGATTCAGCTA -> GATTCAGCTAC
GGATTGGTAGT -> GATTGGTAGTC
GGATTGTCGGA -> GATTGTCGGAG
GGCAAAGCACC -> GCAAAGCACCA
GGCAAGGTGTC -> GCAAGGTGTCC
GGCAATACATG -> GCAATACATGG
GGCAATTCGAT -> GCAATTCGATG
GGCACCGCTAC -> GCACCGCTACG
GGCAGCTAAGA -> GCAGCTAAGAG
GGCAGGCCGCA -> GCAGGCCGCAA
GGCATATCAAT -> GCATATCAATT
GGCATGCTTTA -> GCATGCTTTAT
GGCCCAGAATA -> GCCCAGAATAA
GGCCCCTTGCT -> GCCCCTTGCTG
GGCCGCAACCG -> GCCGCAACCGC
GGCCGCAGTCA -> GCCGCAGTCAA
GGCCGGCTATC -> GCCGGCTATCT
GGCCTCAGAGC -> GCCTCAGAGCA
GGCCTCAGTTT -> GCCTCAGTTTC
GGCCTTATGGA -> GCCTTATGGAG
GGCGCGCCCGT -> GCGCGCCCGTC
GGCGCGCTGGG -> GCGCGCTGGGT
GGCGCGGACAT -> GCGCGGACATG
GGCGCTGGTCG -> GCGCTGGTCGT
GGCGGTCCTCG -> GCGGTCCTCGC
GGCGTTATGTC -> GCGTTATGTCC
GGCGTTCAGCT -> GCGTTCAGCTT
GGCTAATGGGT -> GCTAATGGGTC
GGCTATCTTCC -> GCTATCTTCCC
GGCTCCGCATA -> GCTCCGCATAC
GGCTCTAGAGT -> GCTCTAGAGTC
GGCTCTTCCGT -> GCTCTTCCGTG
GGCTGAGATGT -> GCTGAGATGTG
GGCTGCAGCAC -> GCTGCAGCACG
GGCTGCCTGCA -> GCTGCCTGCAC
GGGAACACTAT -> GGAACACTATA
GGGACCGAACA -> GGACCGAACAT
GGGAGGTACAG -> GGAGGTACAGT
GGGATAGTCTT -> GGATAGTCTTC
GGGATCCTAGG -> GGATCCTAGGC
GGGATTCAATG -> GGATTCAATGT
GGGATTCAGCT -> GGATTCAGCTA
GGGCAATACAT -> GGCAATACATG
GGGCAGCTAAG -> GGCAGCTAAGA
GGGCCCAGAAT -> GGCCCAGAATA
GGGCCCCTTGC -> GGCCCCTTGCT
GGGCCTTATGG -> GGCCTTATGGA
GGGCGCTGGTC -> GGCGCTGGTCG
GGGCTCTTCCG -> GGCTCTTCCGT
GGGGCAATACA -> GGGCAATACAT
GGGGCAGCTAA -> GGGCAGCTAAG
GGGGCCCCTTG -> GGGCCCCTTGC
GGGGCGCTGGT -> GGGCGCTGGTC
GGGGTAGCGCA -> GGGTAGCGCAT
GGGTAGCGCAT -> GGTAGCGCATT
GGGTATCGGAC -> GGTATCGGACT
GGGTCTTCGGC -> GGTCTTCGGCT
GGGTGATTAGA -> GGTGATTAGAC
GGGTGCATGTT -> GGTGCATGTTG
GGGTGTCCCTT -> GGTGTCCCTTC
GGGTTACCCAG -> GGTTACCCAGG
GGTAACGAATC -> GTAACGAATCA
GGTACAGTTTC -> GTACAGTTTCA
GGTAGCGCATT -> GTAGCGCATTC
GGTAGGGGCAG -> GTAGGGGCAGC
GGTAGTAATCC -> GTAGTAATCCC
GGTAGTCCAAC -> GTAGTCCAACA
GGTAGTGGCCT -> GTAGTGGCCTC
GGTAGTTGGTG -> GTAGTTGGTGA
GGTATCGGACT -> GTATCGGACTG
GGTCACGTCCA -> GTCACGTCCAC
GGTCAGACTCT -> GTCAGACTCTT
GGTCCAAATCA -> GTCCAAATCAG
GGTCCTCGCTC -> GTCCTCGCTCG
GGTCGAACCCA -> GTCGAACCCAT
GGTCGCCACAG -> GTCGCCACAGG
GGTCGCCTCAG -> GTCGCCTCAGA
GGTCGTGCGTG -> GTCGTGCGTGC
GGTCTTCGGCT -> GTCTTCGGCTC
GGTGATAGCTA -> GTGATAGCTAG
GGTGATTAGAC -> GTGATTAGACG
GGTGCAGGCAA -> GTGCAGGCAAG
GGTGCATGTTG -> GTGCATGTTGC
GGTGTATCGAT -> GTGTATCGATA
GGTGTCCCTTC -> GTGTCCCTTCT
GGTGTCCGATT -> GTGTCCGATTA
GGTGTGATGTG -> GTGTGATGTGG
GGTTACCCAGG -> GTTACCCAGGC
GGTTAGGCCGG -> GTTAGGCCGGC
GGTTATCGAGC -> GTTATCGAGCA
GGTTCGATGAC -> GTTCGATGACG
GGTTGAAGATA -> GTTGAAGATAA
GGTTTCATCTT -> GTTTCATCTTT
GGTTTCGACAA -> GTTTCGACAAA
GTAAAGATAGA -> TAAAGATAGAC
GTAAATGTCCG -> TAAATGTCCGA
GTAACCGCCTC -> TAACCGCCTCG
GTAACGAATCA -> TAACGAATCAA
GTAATCCCCTG -> TAATCCCCTGG
GTAATGCTTGA -> TAATGCTTGAT
GTAATTCAGGT -> TAATTCAGGTC
GTACAGTTTCA -> TACAGTTTCAC
GTACCGTCTGA -> TACCGTCTGAA
GTACCTCCAGT -> TACCTCCAGTA
GTACCTCGATG -> TACCTCGATGG
GTACGATTGGT -> TACGATTGGTG
GTACGGTTAGG -> TACGGTTAGGC
GTACGTACCGT -> TACGTACCGTC
GTACTGCTTAC -> TACTGCTTACT
GTAGAATAGTA -> TAGAATAGTAA
GTAGCGACATG -> TAGCGACATGA
GTAGCGCATTC -> TAGCGCATTCA
GTAGGGGCAGC -> TAGGGGCAGCT
GTAGTAATCCC -> TAGTAATCCCC
GTAGTATACGT -> TAGTATACGTT
GTAGTCCAACA -> TAGTCCAACAT
GTAGTGGCCTC -> TAGTGGCCTCA
GTAGTTGGTGA -> TAGTTGGTGAT
GTATAACACAC -> TATAACACACA
GTATACGTTTA -> TATACGTTTAC
GTATCGATAGG -> TATCGATAGGC
GTATCGGACTG -> TATCGGACTGA
GTATTCAGTGC -> TATTCAGTGCT
GTATTTACCCA -> TATTTACCCAT
GTCAATGACTC -> TCAATGACTCA
GTCACGTCCAC -> TCACGTCCACA
GTCAGACTCTT -> TCAGACTCTTC
GTCAGTGGAGC -> TCAGTGGAGCG
GTCATTTATAC -> TCATTTATACG
GTCCAAATCAG -> TCCAAATCAGG
GTCCAACATCC -> TCCAACATCCG
GTCCAAGCGCC -> TCCAAGCGCCA
GTCCACAGCCC -> TCCACAGCCCC
GTCCCTTCTAT -> TCCCTTCTATG
GTCCGATGTTC -> TCCGATGTTCA
GTCCGATTACC -> TCCGATTACCC
GTCCTCGCTCG -> TCCTCGCTCGA
GTCGAACCCAT -> TCGAACCCATC
GTCGAAGGATA -> TCGAAGGATAG
GTCGATGCGCT -> TCGATGCGCTC
GTCGCCACAGG -> TCGCCACAGGC
GTCGCCTCAGA -> TCGCCTCAGAA
GTCGCGGGATT -> TCGCGGGATTC
GTCGGAGGTCG -> TCGGAGGTCGA
GTCGGGCCCAG -> TCGGGCCCAGA
GTCGTGCGTGC -> TCGTGCGTGCC
GTCTACATAGG -> TCTACATAGGG
GTCTATCATGG -> TCTATCATGGC
GTCTATCGTTC -> TCTATCGTTCC
GTCTGAAACCT -> TCTGAAACCTG
GTCTGGGGTAG -> TCTGGGGTAGC
GTCTTAGAATA -> TCTTAGAATAC
GTCTTCATTGT -> TCTTCATTGTA
GTCTTCGGCTC -> TCTTCGGCTCC
GTCTTTGCCTA -> TCTTTGCCTAC
GTGACCCTCCT -> TGACCCTCCTC
GTGATAGCTAG -> TGATAGCTAGA
GTGATGTGGGT -> TGATGTGGGTG
GTGATTAGACG -> TGATTAGACGC
GTGCAAACGCT -> TGCAAACGCTA
GTGCAGGCAAG -> TGCAGGCAAGG
GTGCATGTTGC -> TGCATGTTGCT
GTGCCCCGTCT -> TGCCCCGTCTA
GTGCCGACCGG -> TGCCGACCGGA
GTGCGTGCCGA -> TGCGTGCCGAC
GTGCTGCATAA -> TGCTGCATAAT
GTGGAAGTACG -> TGGAAGTACGA
GTGGAGCGCGT -> TGGAGCGCGTA
GTGGATTGTCG -> TGGATTGTCGG
GTGGCCTCAGT -> TGGCCTCAGTT
GTGGGTGCATG -> TGGGTGCATGT
GTGGTCGCCAC -> TGGTCGCCACA
GTGTACCTCGA -> TGTACCTCGAT
GTGTAGTATAC -> TGTAGTATACG
GTGTATCGATA -> TGTATCGATAG
GTGTCCCTTCT -> TGTCCCTTCTA
GTGTCCGATTA -> TGTCCGATTAC
GTGTCGATGCG -> TGTCGATGCGC
GTGTGATGTGG -> TGTGATGTGGG
GTGTGTACCTC -> TGTGTACCTCG
GTGTGTAGTAT -> TGTGTAGTATA
GTGTGTCGATG -> TGTGTCGATGC
GTGTTATCTCA -> TGTTATCTCAA
GTTAACAGAAG -> TTAACAGAAGC
GTTACCCAGGC -> TTACCCAGGCA
GTTAGGCCGGC -> TTAGGCCGGCT
GTTATCGAGCA -> TTATCGAGCAC
GTTATCTCAAA -> TTATCTCAAAC
GTTATGAGGGC -> TTATGAGGGCT
GTTCAGAACTA -> TTCAGAACTAC
GTTCAGCTTAA -> TTCAGCTTAAT
GTTCCCCCGGA -> TTCCCCCGGAT
GTTCGATGACG -> TTCGATGACGT
GTTCTAAATCA -> TTCTAAATCAA
GTTCTGGACCA -> TTCTGGACCAT
GTTGAAGATAA -> TTGAAGATAAA
GTTGATTCATT -> TTGATTCATTA
GTTGCCGCAAA -> TTGCCGCAAAG
GTTGCTACGCG -> TTGCTACGCGA
GTTGGAAACCT -> TTGGAAACCTA
GTTGGACCTAA -> TTGGACCTAAC
GTTGGCGTTCA -> TTGGCGTTCAG
GTTGGTAGGGG -> TTGGTAGGGGC
GTTGGTGATAG -> TTGGTGATAGC
GTTTACACGAG -> TTTACACGAGA
GTTTAGCGTTG -> TTTAGCGTTGA
GTTTCACTAGG -> TTTCACTAGGT
GTTTCATCTTT -> TTTCATCTTTG
GTTTCGACAAA -> TTTCGACAAAG
GTTTCTGGCTG -> TTTCTGGCTGA
GTTTGTAGCGA -> TTTGTAGCGAC
TAAAGATAGAC -> AAAGATAGACC
TAAAGCATTGC -> AAAGCATTGCG
TAAAGTGGAAG -> AAAGTGGAAGT
TAAATCAAGAA -> AAATCAAGAAT
TAAATGTCCGA -> AAATGTCCGAT
TAACAAACACT -> AACAAACACTG
TAACACACAAA -> AACACACAAAC
TAACAGAAGCC -> AACAGAAGCCG
TAACAGGTCGC -> AACAGGTCGCC
TAACCGCCTCG -> AACCGCCTCGC
TAACGAATCAA -> AACGAATCAAG
TAACGCCGCTT -> AACGCCGCTTC
TAACGTACCTC -> AACGTACCTCC
TAAGAGTCTGG -> AAGAGTCTGGG
TAAGCACTCAC -> AAGCACTCACC
TAAGGAAGTAT -> AAGGAAGTATT
TAAGTTCTAAA -> AAGTTCTAAAT
TAATAGTTCTG -> AATAGTTCTGG
TAATCCCCTGG -> AATCCCCTGGG
TAATGCTTGAT -> AATGCTTGATT
TAATGGGTCTT -> AATGGGTCTTC
TAATGTCAGTG -> AATGTCAGTGG
TAATTAGGAAG -> AATTAGGAAGC
TAATTCAGGTC -> AATTCAGGTCA
TACAATGGCAC -> ACAATGGCACC
TACACGAGATC -> ACACGAGATCC
TACAGCTTGAG -> ACAGCTTGAGA
TACAGTTTCAC -> ACAGTTTCACT
TACATAGGGGC -> ACATAGGGGCG
TACATGGATCG -> ACATGGATCGC
TACCACTGTAA -> ACCACTGTAAC
TACCCAGACGG -> ACCCAGACGGC
TACCCAGCAGC -> ACCCAGCAGCC
TACCCAGGCAA -> ACCCAGGCAAA
TACCCATAGGG -> ACCCATAGGGA
TACCGAGAACG -> ACCGAGAACGC
TACCGGCAGGC -> ACCGGCAGGCC
TACCGTAGAAT -> ACCGTAGAATA
TACCGTCTGAA -> ACCGTCTGAAA
TACCTACCGTA -> ACCTACCGTAG
TACCTCAATTG -> ACCTCAATTGT
TACCTCCAGTA -> ACCTCCAGTAT
TACCTCGATGG -> ACCTCGATGGG
TACGAGTGCCC -> ACGAGTGCCCC
TACGATTGGTG -> ACGATTGGTGT
TACGCATCCTC -> ACGCATCCTCG
TACGCGACCTC -> ACGCGACCTCT
TACGCGATCCG -> ACGCGATCCGA
TACGGCATATC -> ACGGCATATCA
TACGGCGGTCC -> ACGGCGGTCCT
TACGGTTAGGC -> ACGGTTAGGCC
TACGGTTGAAG -> ACGGTTGAAGA
TACGTACCGTC -> ACGTACCGTCT
TACGTACGGTT -> ACGTACGGTTA
TACGTTTACAC -> ACGTTTACACG
TACTAGTAAAT -> ACTAGTAAATG
TACTCATCATC -> ACTCATCATCA
TACTCCACGAT -> ACTCCACGATG
TACTGCTTACT -> ACTGCTTACTC
TACTTGGGGCC -> ACTTGGGGCCC
TAGAATACGTA -> AGAATACGTAC
TAGAATAGTAA -> AGAATAGTAAA
TAGACCGGGTG -> AGACCGGGTGT
TAGACGCTTCC -> AGACGCTTCCA
TAGAGTCTACA -> AGAGTCTACAT
TAGATATAAGC -> AGATATAAGCA
TAGATGAGACC -> AGATGAGACCT
TAGCACATTCT -> AGCACATTCTC
TAGCATCAACT -> AGCATCAACTA
TAGCCGTGACC -> AGCCGTGACCC
TAGCCTATTTA -> AGCCTATTTAT
TAGCGACATGA -> AGCGACATGAA
TAGCGCATTCA -> AGCGCATTCAA
TAGCGGACGAT -> AGCGGACGATC
TAGCGTTGATT -> AGCGTTGATTC
TAGCTAGATGA -> AGCTAGATGAG
TAGCTATCTGC -> AGCTATCTGCA
TAGGAAGCTCC -> AGGAAGCTCCG
TAGGCCGGCTA -> AGGCCGGCTAT
TAGGCGCGGAC -> AGGCGCGGACA
TAGGCTAATGG -> AGGCTAATGGG
TAGGGACCGAA -> AGGGACCGAAC
TAGGGGCAGCT -> AGGGGCAGCTA
TAGGGGCGCTG -> AGGGGCGCTGG
TAGGTAACGAA -> AGGTAACGAAT
TAGGTAGTGGC -> AGGTAGTGGCC
TAGGTGCAGGC -> AGGTGCAGGCA
TAGTAAAGATA -> AGTAAAGATAG
TAGTAAATGTC -> AGTAAATGTCC
TAGTAATCCCC -> AGTAATCCCCT
TAGTATACGTT -> AGTATACGTTT
TAGTCCAACAT -> AGTCCAACATC
TAGTCTTCATT -> AGTCTTCATTG
TAGTGGCCTCA -> AGTGGCCTCAG
TAGTGTTATCT -> AGTGTTATCTC
TAGTTCTGGAC -> AGTTCTGGACC
TAGTTGGACCT -> AGTTGGACCTA
TAGTTGGTGAT -> AGTTGGTGATA
TATAACACACA -> ATAACACACAA
TATAAGCACTC -> ATAAGCACTCA
TATAAGTTCTA -> ATAAGTTCTAA
TATACGGCATA -> ATACGGCATAT
TATACGGCGGT -> ATACGGCGGTC
TATACGTTTAC -> ATACGTTTACA
TATCAATTCCA -> ATCAATTCCAG
TATCATGGCGC -> ATCATGGCGCG
TATCGAGCACT -> ATCGAGCACTT
TATCGATAGGC -> ATCGATAGGCT
TATCGGACTGA -> ATCGGACTGAC
TATCGTTCCCC -> ATCGTTCCCCC
TATCTCAAACG -> ATCTCAAACGT
TATCTGCACAC -> ATCTGCACACG
TATCTTCCCAA -> ATCTTCCCAAG
TATGAAGTCGC -> ATGAAGTCGCG
TATGAGACAAT -> ATGAGACAATC
TATGAGGGCTC -> ATGAGGGCTCT
TATGGAGCTAC -> ATGGAGCTACG
TATGGGTTACC -> ATGGGTTACCC
TATTCAGTGCT -> ATTCAGTGCTG
TATTCGGGGCA -> ATTCGGGGCAA
TATTCGTTGGT -> ATTCGTTGGTA
TATTTACCCAT -> ATTTACCCATA
TATTTATACGG -> ATTTATACGGC
TATTTGAATCA -> ATTTGAATCAA
TCAAACGTAAT -> CAAACGTAATG
TCAAATAACAA -> CAAATAACAAA
TCAAATGGCAT -> CAAATGGCATG
TCAACGGCTGC -> CAACGGCTGCA
TCAACTACCAC -> CAACTACCACT
TCAAGAATCCT -> CAAGAATCCTC
TCAAGCAGCCA -> CAAGCAGCCAA
TCAAGGAGTTG -> CAAGGAGTTGG
TCAATGACTCA -> CAATGACTCAA
TCAATGTCTTA -> CAATGTCTTAG
TCAATTCCAGA -> CAATTCCAGAA
TCAATTGTTGC -> CAATTGTTGCC
TCAATTTGAAG -> CAATTTGAAGT
TCACCGTAATT -> CACCGTAATTC
TCACCTTGGTT -> CACCTTGGTTT
TCACGTCCACA -> CACGTCCACAG
TCACTACGGTT -> CACTACGGTTG
TCACTAGGTGC -> CACTAGGTGCA
TCACTTACTCA -> CACTTACTCAT
TCAGAACTACC -> CAGAACTACCT
TCAGAATAAAG -> CAGAATAAAGT
TCAGACTCTTC -> CAGACTCTTCG
TCAGAGCAGTT -> CAGAGCAGTTA
TCAGCTACCGA -> CAGCTACCGAG
TCAGCTTAATA -> CAGCTTAATAG
TCAGGTCACGT -> CAGGTCACGTC
TCAGGTCAGAC -> CAGGTCAGACT
TCAGTGCTGCA -> CAGTGCTGCAT
TCAGTGGAGCG -> CAGTGGAGCGC
TCAGTTTCTGG -> CAGTTTCTGGC
TCATACGCATC -> CATACGCATCC
TCATAGCTATC -> CATAGCTATCT
TCATCAAATAA -> CATCAAATAAC
TCATCATCAAA -> CATCATCAAAT
TCATCTTTGGG -> CATCTTTGGGT
TCATGGCGCGC -> CATGGCGCGCT
TCATTAGCGGA -> CATTAGCGGAC
TCATTCCCCTA -> CATTCCCCTAG
TCATTGTACTG -> CATTGTACTGC
TCATTTATACG -> CATTTATACGG
TCCAAAATTGT -> CCAAAATTGTC
TCCAAATCAGG -> CCAAATCAGGT
TCCAACATCCG -> CCAACATCCGA
TCCAAGCGCCA -> CCAAGCGCCAC
TCCAATTCACC -> CCAATTCACCT
TCCACAGCCCC -> CCACAGCCCCA
TCCACGATGTA -> CCACGATGTAT
TCCAGAAAGTT -> CCAGAAAGTTG
TCCAGTATAAC -> CCAGTATAACA
TCCCAAGGCTC -> CCCAAGGCTCT
TCCCCAATCTA -> CCCCAATCTAC
TCCCCCGGATT -> CCCCCGGATTG
TCCCCTAGGTA -> CCCCTAGGTAA
TCCCCTGGGAT -> CCCCTGGGATC
TCCCTTCTATG -> CCCTTCTATGG
TCCGAATACCG -> CCGAATACCGG
TCCGAATCATT -> CCGAATCATTC
TCCGAATTGCT -> CCGAATTGCTA
TCCGATGTTCA -> CCGATGTTCAG
TCCGATTACCC -> CCGATTACCCA
TCCGCATACTA -> CCGCATACTAG
TCCGGTAGTTG -> CCGGTAGTTGG
TCCGTCTATCA -> CCGTCTATCAT
TCCGTGTGTCG -> CCGTGTGTCGA
TCCTAGGCGCG -> CCTAGGCGCGG
TCCTCGACATT -> CCTCGACATTG
TCCTCGCTCGA -> CCTCGCTCGAA
TCCTCGGCGCG -> CCTCGGCGCGC
TCCTCTTAATT -> CCTCTTAATTA
TCCTCTTTGCT -> CCTCTTTGCTG
TCCTGCTCCTC -> CCTGCTCCTCT
TCGAAATGGCG -> CGAAATGGCGT
TCGAACCCATC -> CGAACCCATCT
TCGAACGAAGT -> CGAACGAAGTC
TCGAAGGATAG -> CGAAGGATAGT
TCGACAAAGAT -> CGACAAAGATT
TCGACATTGAT -> CGACATTGATA
TCGAGCACTTA -> CGAGCACTTAC
TCGAGCAGGTT -> CGAGCAGGTTT
TCGATAGGCTA -> CGATAGGCTAA
TCGATGACGTC -> CGATGACGTCC
TCGATGCACGT -> CGATGCACGTG
TCGATGCGCTC -> CGATGCGCTCT
TCGATGGGATA -> CGATGGGATAG
TCGCAGCGAGA -> CGCAGCGAGAA
TCGCCACAGGC -> CGCCACAGGCA
TCGCCATGTTA -> CGCCATGTTAT
TCGCCTCAGAA -> CGCCTCAGAAT
TCGCGGGATTC -> CGCGGGATTCA
TCGCTATGAAG -> CGCTATGAAGT
TCGCTCGAACG -> CGCTCGAACGA
TCGGACTGACT -> CGGACTGACTA
TCGGAGGTCGA -> CGGAGGTCGAA
TCGGCGCGCCC -> CGGCGCGCCCG
TCGGCTCCGCA -> CGGCTCCGCAT
TCGGGAGGTAC -> CGGGAGGTACA
TCGGGCCCAGA -> CGGGCCCAGAA
TCGGGGCAATA -> CGGGGCAATAC
TCGTCGAAGGA -> CGTCGAAGGAT
TCGTGCGTGCC -> CGTGCGTGCCG
TCGTGTGTACC -> CGTGTGTACCT
TCGTTCCCCCG -> CGTTCCCCCGG
TCGTTGGTAGG -> CGTTGGTAGGG
TCTAAATCAAG -> CTAAATCAAGA
TCTACAGCTTG -> CTACAGCTTGA
TCTACATAGGG -> CTACATAGGGG
TCTACCTCAAT -> CTACCTCAATT
TCTAGAGTCTA -> CTAGAGTCTAC
TCTATCATGGC -> CTATCATGGCG
TCTATCGTTCC -> CTATCGTTCCC
TCTATGGGTTA -> CTATGGGTTAC
TCTCAAACGTA -> CTCAAACGTAA
TCTCCGGTAGT -> CTCCGGTAGTT
TCTCCGTCTAT -> CTCCGTCTATC
TCTCTCCGGTA -> CTCTCCGGTAG
TCTCTGAAGGG -> CTCTGAAGGGA
TCTGAAACCTG -> CTGAAACCTGC
TCTGAAGGGAA -> CTGAAGGGAAC
TCTGCACACGA -> CTGCACACGAA
TCTGGACCATC -> CTGGACCATCA
TCTGGCTGAGA -> CTGGCTGAGAT
TCTGGGGTAGC -> CTGGGGTAGCG
TCTTAATTAGG -> CTTAATTAGGA
TCTTAGAATAC -> CTTAGAATACG
TCTTCATAGCT -> CTTCATAGCTA
TCTTCATTGTA -> CTTCATTGTAC
TCTTCCCAAGG -> CTTCCCAAGGC
TCTTCCGTGTG -> CTTCCGTGTGT
TCTTCGAAATG -> CTTCGAAATGG
TCTTCGGCTCC -> CTTCGGCTCCG
TCTTTGCCTAC -> CTTTGCCTACC
TCTTTGCTGGT -> CTTTGCTGGTC
TCTTTGGGTGA -> CTTTGGGTGAT
TCTTTTGGTAG -> CTTTTGGTAGT
TGAAAAATATT -> GAAAAATATTC
TGAAACCTGCA -> GAAACCTGCAA
TGAAGATAAAG -> GAAGATAAAGC
TGAAGGGAACA -> GAAGGGAACAC
TGAAGTCGCGG -> GAAGTCGCGGG
TGAAGTTTGTA -> GAAGTTTGTAG
TGAATCAATTT -> GAATCAATTTG
TGACAAGGAGA -> GACAAGGAGAG
TGACCCGACGA -> GACCCGACGAT
TGACCCTCCTC -> GACCCTCCTCT
TGACGTCCAAG -> GACGTCCAAGC
TGACTAGTTGG -> GACTAGTTGGA
TGACTCAACGG -> GACTCAACGGC
TGAGACAATCT -> GAGACAATCTA
TGAGACCCATG -> GAGACCCATGC
TGAGACCTTAA -> GAGACCTTAAC
TGAGATGTGTG -> GAGATGTGTGT
TGAGCGCAAAC -> GAGCGCAAACC
TGAGGGCTCTT -> GAGGGCTCTTC
TGATACTTGGG -> GATACTTGGGG
TGATAGCTAGA -> GATAGCTAGAT
TGATCTTCATA -> GATCTTCATAG
TGATGTGGGTG -> GATGTGGGTGC
TGATTAGACGC -> GATTAGACGCT
TGATTCATTAG -> GATTCATTAGC
TGATTGGGATT -> GATTGGGATTC
TGATTTTCCTG -> GATTTTCCTGC
TGCAAACGCTA -> GCAAACGCTAG
TGCAACGATGA -> GCAACGATGAC
TGCACAATAGC -> GCACAATAGCC
TGCACACGAAG -> GCACACGAAGT
TGCACGTGCAA -> GCACGTGCAAA
TGCAGCACGGA -> GCAGCACGGAC
TGCAGGCAAGG -> GCAGGCAAGGT
TGCAGTGGATT -> GCAGTGGATTG
TGCATAATGTC -> GCATAATGTCA
TGCATGTTGCT -> GCATGTTGCTA
TGCCCCGTCTA -> GCCCCGTCTAT
TGCCGACCGGA -> GCCGACCGGAT
TGCCGCAAAGG -> GCCGCAAAGGC
TGCCTACCCAG -> GCCTACCCAGA
TGCCTGCACAA -> GCCTGCACAAT
TGCGCTCTCTC -> GCGCTCTCTCC
TGCGGCTGCCT -> GCGGCTGCCTG
TGCGGTGTATC -> GCGGTGTATCG
TGCGTGCCGAC -> GCGTGCCGACC
TGCTACGCGAT -> GCTACGCGATC
TGCTATTCGTT -> GCTATTCGTTG
TGCTCCTCTTA -> GCTCCTCTTAA
TGCTCGTCGAA -> GCTCGTCGAAG
TGCTGCATAAT -> GCTGCATAATG
TGCTGCGGTGT -> GCTGCGGTGTA
TGCTGCTCGTC -> GCTGCTCGTCG
TGCTGGTCCAA -> GCTGGTCCAAA
TGCTTACTCCA -> GCTTACTCCAC
TGCTTGATTGG -> GCTTGATTGGG
TGCTTTATTTG -> GCTTTATTTGA
TGGAAACCTAG -> GGAAACCTAGC
TGGAAGTACGA -> GGAAGTACGAT
TGGACCATCAA -> GGACCATCAAA
TGGACCTAACA -> GGACCTAACAG
TGGAGCGCGTA -> GGAGCGCGTAC
TGGAGCTACGA -> GGAGCTACGAG
TGGATCACTTA -> GGATCACTTAC
TGGATCGCTAT -> GGATCGCTATG
TGGATTGTCGG -> GGATTGTCGGA
TGGCACCGCTA -> GGCACCGCTAC
TGGCATGCTTT -> GGCATGCTTTA
TGGCCTCAGTT -> GGCCTCAGTTT
TGGCGCGCTGG -> GGCGCGCTGGG
TGGCGTTATGT -> GGCGTTATGTC
TGGCGTTCAGC -> GGCGTTCAGCT
TGGCTGAGATG -> GGCTGAGATGT
TGGGATAGTCT -> GGGATAGTCTT
TGGGATCCTAG -> GGGATCCTAGG
TGGGATTCAAT -> GGGATTCAATG
TGGGGCCCCTT -> GGGGCCCCTTG
TGGGGTAGCGC -> GGGGTAGCGCA
TGGGTATCGGA -> GGGTATCGGAC
TGGGTCTTCGG -> GGGTCTTCGGC
TGGGTGATTAG -> GGGTGATTAGA
TGGGTGCATGT -> GGGTGCATGTT
TGGGTTACCCA -> GGGTTACCCAG
TGGTAGGGGCA -> GGTAGGGGCAG
TGGTAGTAATC -> GGTAGTAATCC
TGGTAGTCCAA -> GGTAGTCCAAC
TGGTCCAAATC -> GGTCCAAATCA
TGGTCGCCACA -> GGTCGCCACAG
TGGTCGTGCGT -> GGTCGTGCGTG
TGGTGATAGCT -> GGTGATAGCTA
TGGTGTGATGT -> GGTGTGATGTG
TGGTTATCGAG -> GGTTATCGAGC
TGGTTTCATCT -> GGTTTCATCTT
TGTAACCGCCT -> GTAACCGCCTC
TGTACCTCGAT -> GTACCTCGATG
TGTACTGCTTA -> GTACTGCTTAC
TGTAGCGACAT -> GTAGCGACATG
TGTAGTATACG -> GTAGTATACGT
TGTATCGATAG -> GTATCGATAGG
TGTATTTACCC -> GTATTTACCCA
TGTCAGTGGAG -> GTCAGTGGAGC
TGTCATTTATA -> GTCATTTATAC
TGTCCCTTCTA -> GTCCCTTCTAT
TGTCCGATGTT -> GTCCGATGTTC
TGTCCGATTAC -> GTCCGATTACC
TGTCGATGCGC -> GTCGATGCGCT
TGTCGGAGGTC -> GTCGGAGGTCG
TGTCTTAGAAT -> GTCTTAGAATA
TGTGATGTGGG -> GTGATGTGGGT
TGTGGGTGCAT -> GTGGGTGCATG
TGTGTACCTCG -> GTGTACCTCGA
TGTGTAGTATA -> GTGTAGTATAC
TGTGTCGATGC -> GTGTCGATGCG
TGTGTGTAGTA -> GTGTGTAGTAT
TGTTATCTCAA -> GTTATCTCAAA
TGTTATGAGGG -> GTTATGAGGGC
TGTTCAGAACT -> GTTCAGAACTA
TGTTGCCGCAA -> GTTGCCGCAAA
TGTTGCTACGC -> GTTGCTACGCG
TTAACAGAAGC -> TAACAGAAGCC
TTAACGCCGCT -> TAACGCCGCTT
TTAATAGTTCT -> TAATAGTTCTG
TTAATTAGGAA -> TAATTAGGAAG
TTACAATGGCA -> TACAATGGCAC
TTACACGAGAT -> TACACGAGATC
TTACCCAGCAG -> TACCCAGCAGC
TTACCCAGGCA -> TACCCAGGCAA
TTACCCATAGG -> TACCCATAGGG
TTACTCATCAT -> TACTCATCATC
TTACTCCACGA -> TACTCCACGAT
TTAGAATACGT -> TAGAATACGTA
TTAGACGCTTC -> TAGACGCTTCC
TTAGCGGACGA -> TAGCGGACGAT
TTAGCGTTGAT -> TAGCGTTGATT
TTAGGAAGCTC -> TAGGAAGCTCC
TTAGGCCGGCT -> TAGGCCGGCTA
TTAGGTAGTGG -> TAGGTAGTGGC
TTATACGGCAT -> TATACGGCATA
TTATACGGCGG -> TATACGGCGGT
TTATCGAGCAC -> TATCGAGCACT
TTATCTCAAAC -> TATCTCAAACG
TTATGAGACAA -> TATGAGACAAT
TTATGAGGGCT -> TATGAGGGCTC
TTATGGAGCTA -> TATGGAGCTAC
TTATTTGAATC -> TATTTGAATCA
TTCAAGGAGTT -> TCAAGGAGTTG
TTCAATGTCTT -> TCAATGTCTTA
TTCACCTTGGT -> TCACCTTGGTT
TTCACTAGGTG -> TCACTAGGTGC
TTCAGAACTAC -> TCAGAACTACC
TTCAGCTACCG -> TCAGCTACCGA
TTCAGCTTAAT -> TCAGCTTAATA
TTCAGGTCAGA -> TCAGGTCAGAC
TTCAGTGCTGC -> TCAGTGCTGCA
TTCATACGCAT -> TCATACGCATC
TTCATAGCTAT -> TCATAGCTATC
TTCATCTTTGG -> TCATCTTTGGG
TTCATTAGCGG -> TCATTAGCGGA
TTCATTGTACT -> TCATTGTACTG
TTCCAAAATTG -> TCCAAAATTGT
TTCCAGAAAGT -> TCCAGAAAGTT
TTCCCAAGGCT -> TCCCAAGGCTC
TTCCCCCGGAT -> TCCCCCGGATT
TTCCCCTAGGT -> TCCCCTAGGTA
TTCCGTGTGTC -> TCCGTGTGTCG
TTCCTGCTCCT -> TCCTGCTCCTC
TTCGAAATGGC -> TCGAAATGGCG
TTCGACAAAGA -> TCGACAAAGAT
TTCGAGCAGGT -> TCGAGCAGGTT
TTCGATGACGT -> TCGATGACGTC
TTCGATGCACG -> TCGATGCACGT
TTCGGCTCCGC -> TCGGCTCCGCA
TTCGGGAGGTA -> TCGGGAGGTAC
TTCGGGGCAAT -> TCGGGGCAATA
TTCGTTGGTAG -> TCGTTGGTAGG
TTCTAAATCAA -> TCTAAATCAAG
TTCTATGGGTT -> TCTATGGGTTA
TTCTCCGTCTA -> TCTCCGTCTAT
TTCTGGACCAT -> TCTGGACCATC
TTCTGGCTGAG -> TCTGGCTGAGA
TTGAAGATAAA -> TGAAGATAAAG
TTGAAGTTTGT -> TGAAGTTTGTA
TTGAATCAATT -> TGAATCAATTT
TTGACAAGGAG -> TGACAAGGAGA
TTGAGACCCAT -> TGAGACCCATG
TTGATACTTGG -> TGATACTTGGG
TTGATTCATTA -> TGATTCATTAG
TTGATTGGGAT -> TGATTGGGATT
TTGCCGCAAAG -> TGCCGCAAAGG
TTGCCTACCCA -> TGCCTACCCAG
TTGCGGCTGCC -> TGCGGCTGCCT
TTGCTACGCGA -> TGCTACGCGAT
TTGCTATTCGT -> TGCTATTCGTT
TTGCTGCTCGT -> TGCTGCTCGTC
TTGCTGGTCCA -> TGCTGGTCCAA
TTGGAAACCTA -> TGGAAACCTAG
TTGGACCTAAC -> TGGACCTAACA
TTGGCGTTCAG -> TGGCGTTCAGC
TTGGGATTCAA -> TGGGATTCAAT
TTGGGGCCCCT -> TGGGGCCCCTT
TTGGGTGATTA -> TGGGTGATTAG
TTGGTAGGGGC -> TGGTAGGGGCA
TTGGTAGTAAT -> TGGTAGTAATC
TTGGTAGTCCA -> TGGTAGTCCAA
TTGGTGATAGC -> TGGTGATAGCT
TTGGTGTGATG -> TGGTGTGATGT
TTGGTTTCATC -> TGGTTTCATCT
TTGTACTGCTT -> TGTACTGCTTA
TTGTAGCGACA -> TGTAGCGACAT
TTGTCATTTAT -> TGTCATTTATA
TTGTCGGAGGT -> TGTCGGAGGTC
TTGTTGCCGCA -> TGTTGCCGCAA
TTTACACGAGA -> TTACACGAGAT
TTTACCCATAG -> TTACCCATAGG
TTTAGCGTTGA -> TTAGCGTTGAT
TTTATACGGCA -> TTATACGGCAT
TTTATACGGCG -> TTATACGGCGG
TTTATTTGAAT -> TTATTTGAATC
TTTCACTAGGT -> TTCACTAGGTG
TTTCATACGCA -> TTCATACGCAT
TTTCATCTTTG -> TTCATCTTTGG
TTTCCTGCTCC -> TTCCTGCTCCT
TTTCGACAAAG -> TTCGACAAAGA
TTTCGGGAGGT -> TTCGGGAGGTA
TTTCTGGCTGA -> TTCTGGCTGAG
TTTGAAGTTTG -> TTGAAGTTTGT
TTTGAATCAAT -> TTGAATCAATT
TTTGCCTACCC -> TTGCCTACCCA
TTTGCTGGTCC -> TTGCTGGTCCA
TTTGGGTGATT -> TTGGGTGATTA
TTTGGTAGTAA -> TTGGTAGTAAT
TTTGTAGCGAC -> TTGTAGCGACA
TTTTCCTGCTC -> TTTCCTGCTCC
TTTTGGTAGTA -> TTTGGTAGTAA
