AAAAACCACTGATAGCCCT -> AAAACCACTGATAGCCCTA
AAAAACTTGCGGGTAGATT -> AAAACTTGCGGGTAGATTT
AAAAAGCACTACCACCCAA -> AAAAGCACTACCACCCAAT
AAAACCACTGATAGCCCTA -> AAACCACTGATAGCCCTAA
AAAACTTGCGGGTAGATTT -> AAACTTGCGGGTAGATTTA
AAAAGAGCCTGAATTAGGA -> AAAGAGCCTGAATTAGGAA
AAAAGATAATCTCTACCAG -> AAAGATAATCTCTACCAGG
AAAAGCACTACCACCCAAT -> AAAGCACTACCACCCAATA
AAAAGCTCCATATCACTCA -> AAAGCTCCATATCACTCAC
AAAAGGCCACGATACGGGG -> AAAGGCCACGATACGGGGA
AAAAGTAGGAGGGCGGTCG -> AAAGTAGGAGGGCGGTCGT
AAACATGCTTTCCCGAGAG -> AACATGCTTTCCCGAGAGA
AAACCACTGATAGCCCTAA -> AACCACTGATAGCCCTAAT
AAACCGGCCTACCAGGAAG -> AACCGGCCTACCAGGAAGC
AAACGTTACAAAAAGCACT -> AACGTTACAAAAAGCACTA
AAACTGAATCAGGCATAGG -> AACTGAATCAGGCATAGGG
AAACTTGCGGGTAGATTTA -> AACTTGCGGGTAGATTTAA
AAAGAAGCGGACACTCGCG -> AAGAAGCGGACACTCGCGG
AAAGACATCTTGGCGACCA -> AAGACATCTTGGCGACCAC
AAAGAGCCTGAATTAGGAA -> AAGAGCCTGAATTAGGAAC
AAAGATAATCTCTACCAGG -> AAGATAATCTCTACCAGGC
AAAGCACTACCACCCAATA -> AAGCACTACCACCCAATAA
AAAGCTCCATATCACTCAC -> AAGCTCCATATCACTCACT
AAAGCTGCATTTCGGGTTC -> AAGCTGCATTTCGGGTTCG
AAAGGCCACGATACGGGGA -> AAGGCCACGATACGGGGAA
AAAGGTAGGGCCGGGCACG -> AAGGTAGGGCCGGGCACGT
AAAGTAGGAGGGCGGTCGT -> AAGTAGGAGGGCGGTCGTC
AAATACCGACATTTAGTTG -> AATACCGACATTTAGTTGT
AAATCTGGTTAATTGACCC -> AATCTGGTTAATTGACCCC
AAATGGGCTAGACAAATAC -> AATGGGCTAGACAAATACC
AAATGGTGCTACTTGGTAT -> AATGGTGCTACTTGGTATG
AAATTCACTCGAGGATCGT -> AATTCACTCGAGGATCGTC
AAATTCGTCCAGACAAGGA -> AATTCGTCCAGACAAGGAA
AAATTTCTGAACGGTACTA -> AATTTCTGAACGGTACTAT
AACAACAAGTAATTTAGCG -> ACAACAAGTAATTTAGCGA
AACAACAAGTACCCAAAAA -> ACAACAAGTACCCAAAAAC
AACAACAAGTAGAAGCGGT -> ACAACAAGTAGAAGCGGTT
AACAACAAGTATACCTGGC -> ACAACAAGTATACCTGGCT
AACAAGCAGGTCCCCACTT -> ACAAGCAGGTCCCCACTTC
AACAAGTAATTTAGCGAGT -> ACAAGTAATTTAGCGAGTG
AACAAGTACCCAAAAACTT -> ACAAGTACCCAAAAACTTG
AACAAGTAGAAGCGGTTTT -> ACAAGTAGAAGCGGTTTTG
AACAAGTATACCTGGCTAT -> ACAAGTATACCTGGCTATG
AACACGCCCCAGTCCACAA -> ACACGCCCCAGTCCACAAT
AACAGTGATGGATGCGGGT -> ACAGTGATGGATGCGGGTA
AACATGCTTTCCCGAGAGA -> ACATGCTTTCCCGAGAGAG
AACCACTGATAGCCCTAAT -> ACCACTGATAGCCCTAATG
AACCATTTATTCAGGGCCT -> ACCATTTATTCAGGGCCTC
AACCCACCACTCGTCACGA -> ACCCACCACTCGTCACGAT
AACCGGCCTACCAGGAAGC -> ACCGGCCTACCAGGAAGCT
AACGCGGACTTCGCCACTC -> ACGCGGACTTCGCCACTCT
AACGCTATGCCGGAAAGAC -> ACGCTATGCCGGAAAGACA
AACGGTACTATCCCCTGGC -> ACGGTACTATCCCCTGGCA
AACGTGGAAAAGCTCCATA -> ACGTGGAAAAGCTCCATAT
AACGTTACAAAAAGCACTA -> ACGTTACAAAAAGCACTAC
AACTACCTGGAAAAGAGCC -> ACTACCTGGAAAAGAGCCT
AACTCCCGCAATGTACCGC -> ACTCCCGCAATGTACCGCT
AACTGAATCAGGCATAGGG -> ACTGAATCAGGCATAGGGC
AACTTGCGGGTAGATTTAA -> ACTTGCGGGTAGATTTAAT
AAGAAAGAAGCGGACACTC -> AGAAAGAAGCGGACACTCG
AAGAACGCGGACTTCGCCA -> AGAACGCGGACTTCGCCAC
AAGAAGCGGACACTCGCGG -> AGAAGCGGACACTCGCGGC
AAGAATGCATTCCGCGGGC -> AGAATGCATTCCGCGGGCT
AAGACATCTTGGCGACCAC -> AGACATCTTGGCGACCACT
AAGACCCGCCGTAGTCATA -> AGACCCGCCGTAGTCATAC
AAGACGGCAATTGCATAGT -> AGACGGCAATTGCATAGTT
AAGACGTGCCACTATGAGC -> AGACGTGCCACTATGAGCT
AAGACTAGCCTACAAAGGT -> AGACTAGCCTACAAAGGTA
AAGAGCCTGAATTAGGAAC -> AGAGCCTGAATTAGGAACA
AAGATAATCTCTACCAGGC -> AGATAATCTCTACCAGGCC
AAGATATAAGTGATAAGGA -> AGATATAAGTGATAAGGAC
AAGATTTATGAACACGCCC -> AGATTTATGAACACGCCCC
AAGCACTACCACCCAATAA -> AGCACTACCACCCAATAAT
AAGCAGGTCCCCACTTCGA -> AGCAGGTCCCCACTTCGAG
AAGCCTCTCCCAGTTTTCG -> AGCCTCTCCCAGTTTTCGG
AAGCGGACACTCGCGGCAG -> AGCGGACACTCGCGGCAGC
AAGCGGTTTTGCGGGTAGA -> AGCGGTTTTGCGGGTAGAT
AAGCTAACAACAAGTAATT -> AGCTAACAACAAGTAATTT
AAGCTAACAACAAGTACCC -> AGCTAACAACAAGTACCCA
AAGCTAACAACAAGTAGAA -> AGCTAACAACAAGTAGAAG
AAGCTAACAACAAGTATAC -> AGCTAACAACAAGTATACC
AAGCTCCATATCACTCACT -> AGCTCCATATCACTCACTA
AAGCTGCATTTCGGGTTCG -> AGCTGCATTTCGGGTTCGT
AAGCTTGATGTTGCTTGTT -> AGCTTGATGTTGCTTGTTT
AAGGAAGGTAGTCCCTCGT -> AGGAAGGTAGTCCCTCGTT
AAGGACTCCGGGCATTCTG -> AGGACTCCGGGCATTCTGC
AAGGCCACGATACGGGGAA -> AGGCCACGATACGGGGAAC
AAGGCGGTAGGGAAGCTAA -> AGGCGGTAGGGAAGCTAAC
AAGGGACATCTCCAGCGCG -> AGGGACATCTCCAGCGCGT
AAGGGCAATCAATGGCCTC -> AGGGCAATCAATGGCCTCT
AAGGTACTCATATTCACAG -> AGGTACTCATATTCACAGC
AAGGTAGGGCCGGGCACGT -> AGGTAGGGCCGGGCACGTA
AAGGTAGTCCCTCGTTGAT -> AGGTAGTCCCTCGTTGATG
AAGTAAACGTTACAAAAAG -> AGTAAACGTTACAAAAAGC
AAGTAATTTAGCGAGTGCG -> AGTAATTTAGCGAGTGCGG
AAGTACCCAAAAACTTGCG -> AGTACCCAAAAACTTGCGG
AAGTAGAAGCGGTTTTGCG -> AGTAGAAGCGGTTTTGCGG
AAGTAGGAGGGCGGTCGTC -> AGTAGGAGGGCGGTCGTCC
AAGTATACCTGGCTATGCG -> AGTATACCTGGCTATGCGG
AAGTCTAGCCTAAATTCGT -> AGTCTAGCCTAAATTCGTC
AAGTCTAGGTCACCATACC -> AGTCTAGGTCACCATACCA
AAGTGATAAGGACTCCGGG -> AGTGATAAGGACTCCGGGC
AAGTTGGACGATAGCAATG -> AGTTGGACGATAGCAATGG
AAGTTTAAGTTGGACGATA -> AGTTTAAGTTGGACGATAG
AATAAAGCTGCATTTCGGG -> ATAAAGCTGCATTTCGGGT
AATAATAAAGCTGCATTTC -> ATAATAAAGCTGCATTTCG
AATACCGACATTTAGTTGT -> ATACCGACATTTAGTTGTC
AATATCGGGGGGCCAGAGG -> ATATCGGGGGGCCAGAGGG
AATCAATGGCCTCTAGGTC -> ATCAATGGCCTCTAGGTCG
AATCAGATGCAGTATACGT -> ATCAGATGCAGTATACGTA
AATCAGGCATAGGGCTGAT -> ATCAGGCATAGGGCTGATG
AATCGATAGCGGATCGTCT -> ATCGATAGCGGATCGTCTT
AATCTCCCACCCGCTCCGA -> ATCTCCCACCCGCTCCGAT
AATCTCCCACGAGCCCAGA -> ATCTCCCACGAGCCCAGAG
AATCTCCCCGATTCATCTA -> ATCTCCCCGATTCATCTAC
AATCTCCTCCGACGGAAGA -> ATCTCCTCCGACGGAAGAA
AATCTCGTATTCTGCATCA -> ATCTCGTATTCTGCATCAG
AATCTCTACCAGGCCTCCC -> ATCTCTACCAGGCCTCCCT
AATCTGCATCTACATATTG -> ATCTGCATCTACATATTGC
AATCTGGTTAATTGACCCC -> ATCTGGTTAATTGACCCCG
AATGAAGTTTAAGTTGGAC -> ATGAAGTTTAAGTTGGACG
AATGCATTCCGCGGGCTTA -> ATGCATTCCGCGGGCTTAC
AATGCCCCTCGCTGCGTCG -> ATGCCCCTCGCTGCGTCGA
AATGCCGATCGTCAGCAGG -> ATGCCGATCGTCAGCAGGG
AATGCCTTTAGAAACCGGC -> ATGCCTTTAGAAACCGGCC
AATGGCCTCTAGGTCGGTG -> ATGGCCTCTAGGTCGGTGA
AATGGGCCAAATTTCTGAA -> ATGGGCCAAATTTCTGAAC
AATGGGCTAGACAAATACC -> ATGGGCTAGACAAATACCG
AATGGTGCTACTTGGTATG -> ATGGTGCTACTTGGTATGA
AATGGTTTCCGCCTTCGGT -> ATGGTTTCCGCCTTCGGTT
AATGTACCGCTCCTGCAAA -> ATGTACCGCTCCTGCAAAA
AATGTTCGCCAGCCTGAAG -> ATGTTCGCCAGCCTGAAGA
AATTAGGAACAGTGATGGA -> ATTAGGAACAGTGATGGAT
AATTCAAGCCTCTCCCAGT -> ATTCAAGCCTCTCCCAGTT
AATTCACCCGGCGCCTCTG -> ATTCACCCGGCGCCTCTGG
AATTCACTCGAGGATCGTC -> ATTCACTCGAGGATCGTCT
AATTCGTCCAGACAAGGAA -> ATTCGTCCAGACAAGGAAG
AATTCTGTAAGTAAACGTT -> ATTCTGTAAGTAAACGTTA
AATTGACCCCGATCACATG -> ATTGACCCCGATCACATGT
AATTGAGCTCTGAGTAGAG -> ATTGAGCTCTGAGTAGAGC
AATTGCATAGTTGCCGCGG -> ATTGCATAGTTGCCGCGGA
AATTTAGCAAGATTTATGA -> ATTTAGCAAGATTTATGAA
AATTTAGCGAGTGCGGGTA -> ATTTAGCGAGTGCGGGTAG
AATTTCTGAACGGTACTAT -> ATTTCTGAACGGTACTATC
AATTTGTTAGCTGTCTACG -> ATTTGTTAGCTGTCTACGA
ACAAAAAGCACTACCACCC -> CAAAAAGCACTACCACCCA
ACAAAAGGCCACGATACGG -> CAAAAGGCCACGATACGGG
ACAAAGGTAAATTAGAGTG -> CAAAGGTAAATTAGAGTGA
ACAAATACCGACATTTAGT -> CAAATACCGACATTTAGTT
ACAAATGGTGCTACTTGGT -> CAAATGGTGCTACTTGGTA
ACAACAAGTAATTTAGCGA -> CAACAAGTAATTTAGCGAG
ACAACAAGTACCCAAAAAC -> CAACAAGTACCCAAAAACT
ACAACAAGTAGAAGCGGTT -> CAACAAGTAGAAGCGGTTT
ACAACAAGTATACCTGGCT -> CAACAAGTATACCTGGCTA
ACAAGAAAGAAGCGGACAC -> CAAGAAAGAAGCGGACACT
ACAAGCAGGTCCCCACTTC -> CAAGCAGGTCCCCACTTCG
ACAAGGAAGGTAGTCCCTC -> CAAGGAAGGTAGTCCCTCG
ACAAGTAATTTAGCGAGTG -> CAAGTAATTTAGCGAGTGC
ACAAGTACCCAAAAACTTG -> CAAGTACCCAAAAACTTGC
ACAAGTAGAAGCGGTTTTG -> CAAGTAGAAGCGGTTTTGC
ACAAGTATACCTGGCTATG -> CAAGTATACCTGGCTATGC
ACAATCTCGTATTCTGCAT -> CAATCTCGTATTCTGCATC
ACAATTTAGCAAGATTTAT -> CAATTTAGCAAGATTTATG
ACACCGAACTCCCGCAATG -> CACCGAACTCCCGCAATGT
ACACGCCCCAGTCCACAAT -> CACGCCCCAGTCCACAATC
ACACTCGCGGCAGCCAAGG -> CACTCGCGGCAGCCAAGGG
ACAGCCCGTAGCGTGATTA -> CAGCCCGTAGCGTGATTAT
ACAGTGATGGATGCGGGTA -> CAGTGATGGATGCGGGTAC
ACATATTGCCGTTCGAAGT -> CATATTGCCGTTCGAAGTC
ACATCTCCAGCGCGTACTA -> CATCTCCAGCGCGTACTAT
ACATCTTAGGCGACGGAAG -> CATCTTAGGCGACGGAAGT
ACATCTTGGCGACCACTCC -> CATCTTGGCGACCACTCCA
ACATGCTTTCCCGAGAGAG -> CATGCTTTCCCGAGAGAGA
ACATGTGCTATTAAGGTAC -> CATGTGCTATTAAGGTACT
ACATTTAGTTGTCGCCCAA -> CATTTAGTTGTCGCCCAAT
ACCAATCTGCATCTACATA -> CCAATCTGCATCTACATAT
ACCACCCAATAATAAAGCT -> CCACCCAATAATAAAGCTG
ACCACCTGGGAGTATAGAT -> CCACCTGGGAGTATAGATC
ACCACTCCAGTTCGATGGA -> CCACTCCAGTTCGATGGAC
ACCACTCGTCACGATTTGT -> CCACTCGTCACGATTTGTC
ACCACTGATAGCCCTAATG -> CCACTGATAGCCCTAATGC
ACCAGGAAGCTAACAACAA -> CCAGGAAGCTAACAACAAG
ACCAGGACGGGTAGCCCGG -> CCAGGACGGGTAGCCCGGG
ACCAGGCCTCCCTCTTAGC -> CCAGGCCTCCCTCTTAGCA
ACCAGTTCTCTATTGAGTC -> CCAGTTCTCTATTGAGTCG
ACCATACCAGTTCTCTATT -> CCATACCAGTTCTCTATTG
ACCATTTATTCAGGGCCTC -> CCATTTATTCAGGGCCTCC
ACCCAAAAACTTGCGGGTA -> CCCAAAAACTTGCGGGTAG
ACCCAATAATAAAGCTGCA -> CCCAATAATAAAGCTGCAT
ACCCAATTTGTTAGCTGTC -> CCCAATTTGTTAGCTGTCT
ACCCACCACTCGTCACGAT -> CCCACCACTCGTCACGATT
ACCCCGATCACATGTGCTA -> CCCCGATCACATGTGCTAT
ACCCCGATGCCAAGAATGC -> CCCCGATGCCAAGAATGCA
ACCCGCCGTAGTCATACTA -> CCCGCCGTAGTCATACTAC
ACCCGCTCCGATCCGCCAA -> CCCGCTCCGATCCGCCAAT
ACCCGGCGCCTCTGGCCGA -> CCCGGCGCCTCTGGCCGAC
ACCCTCTGGGGCACCAATC -> CCCTCTGGGGCACCAATCT
ACCCTGACGGCCTGGCCCG -> CCCTGACGGCCTGGCCCGG
ACCCTTGAAACATGCTTTC -> CCCTTGAAACATGCTTTCC
ACCGAACTCCCGCAATGTA -> CCGAACTCCCGCAATGTAC
ACCGACAATTTAGCAAGAT -> CCGACAATTTAGCAAGATT
ACCGACATTTAGTTGTCGC -> CCGACATTTAGTTGTCGCC
ACCGATCCTTCCCGAATGG -> CCGATCCTTCCCGAATGGG
ACCGCTCCTGCAAAAGATA -> CCGCTCCTGCAAAAGATAA
ACCGGCCTACCAGGAAGCT -> CCGGCCTACCAGGAAGCTA
ACCTCACTATTGGTAATAT -> CCTCACTATTGGTAATATC
ACCTCTTAAGACGGCAATT -> CCTCTTAAGACGGCAATTG
ACCTCTTGCTTGTTAAATG -> CCTCTTGCTTGTTAAATGG
ACCTGGAAAAGAGCCTGAA -> CCTGGAAAAGAGCCTGAAT
ACCTGGCTATGCGGGTAGA -> CCTGGCTATGCGGGTAGAT
ACCTGGGAGTATAGATCAT -> CCTGGGAGTATAGATCATC
ACGACACCGAACTCCCGCA -> CGACACCGAACTCCCGCAA
ACGACCACCTGGGAGTATA -> CGACCACCTGGGAGTATAG
ACGACCGATCCTTCCCGAA -> CGACCGATCCTTCCCGAAT
ACGAGCCCAGAGATACTCC -> CGAGCCCAGAGATACTCCT
ACGATACGGGGAACCCACC -> CGATACGGGGAACCCACCA
ACGATACTATAGCGGCGAT -> CGATACTATAGCGGCGATA
ACGATAGCAATGGTTTCCG -> CGATAGCAATGGTTTCCGC
ACGATTTGTCGCCCTTTGT -> CGATTTGTCGCCCTTTGTA
ACGCACCTCTTAAGACGGC -> CGCACCTCTTAAGACGGCA
ACGCCCCAGTCCACAATCT -> CGCCCCAGTCCACAATCTC
ACGCGGACTTCGCCACTCT -> CGCGGACTTCGCCACTCTA
ACGCGTACCCCGATGCCAA -> CGCGTACCCCGATGCCAAG
ACGCTATGCCGGAAAGACA -> CGCTATGCCGGAAAGACAT
ACGCTTGCAAGGCGGTAGG -> CGCTTGCAAGGCGGTAGGG
ACGGAACCATTTATTCAGG -> CGGAACCATTTATTCAGGG
ACGGAAGAACGCGGACTTC -> CGGAAGAACGCGGACTTCG
ACGGAAGTCTAGCCTAAAT -> CGGAAGTCTAGCCTAAATT
ACGGCAATTGCATAGTTGC -> CGGCAATTGCATAGTTGCC
ACGGCCACCTCACTATTGG -> CGGCCACCTCACTATTGGT
ACGGCCTGGCCCGGGTTCC -> CGGCCTGGCCCGGGTTCCA
ACGGCTCATTACCAGGACG -> CGGCTCATTACCAGGACGG
ACGGGGAACCCACCACTCG -> CGGGGAACCCACCACTCGT
ACGGGTAGCCCGGGATGTG -> CGGGTAGCCCGGGATGTGG
ACGGTACTATCCCCTGGCA -> CGGTACTATCCCCTGGCAT
ACGGTTACAAAAGGCCACG -> CGGTTACAAAAGGCCACGA
ACGTAAGCTTGATGTTGCT -> CGTAAGCTTGATGTTGCTT
ACGTACTAGCTTAATCAGA -> CGTACTAGCTTAATCAGAT
ACGTAGGCGAGGGAAGGGC -> CGTAGGCGAGGGAAGGGCA
ACGTAGTATTGATACCCAA -> CGTAGTATTGATACCCAAT
ACGTCTTACGGCCACCTCA -> CGTCTTACGGCCACCTCAC
ACGTGCCACTATGAGCTTC -> CGTGCCACTATGAGCTTCG
ACGTGGAAAAGCTCCATAT -> CGTGGAAAAGCTCCATATC
ACGTTACAAAAAGCACTAC -> CGTTACAAAAAGCACTACC
ACGTTTCCCCTTGAATGAA -> CGTTTCCCCTTGAATGAAG
ACTACCACCCAATAATAAA -> CTACCACCCAATAATAAAG
ACTACCTGGAAAAGAGCCT -> CTACCTGGAAAAGAGCCTG
ACTACTGCATTACCCTCTG -> CTACTGCATTACCCTCTGG
ACTAGCCTACAAAGGTAAA -> CTAGCCTACAAAGGTAAAT
ACTAGCGTCCCACGCGTAC -> CTAGCGTCCCACGCGTACC
ACTAGCTTAATCAGATGCA -> CTAGCTTAATCAGATGCAG
ACTATAGCGGCGATACTTA -> CTATAGCGGCGATACTTAT
ACTATCCCCTGGCATAATC -> CTATCCCCTGGCATAATCG
ACTATGAGCTTCGCTAGCT -> CTATGAGCTTCGCTAGCTC
ACTATGGTACTGACGACCA -> CTATGGTACTGACGACCAC
ACTATTGGTAATATCGGGG -> CTATTGGTAATATCGGGGG
ACTCACTAGCGTCCCACGC -> CTCACTAGCGTCCCACGCG
ACTCATATTCACAGCCCGT -> CTCATATTCACAGCCCGTA
ACTCCAGTTCGATGGACGA -> CTCCAGTTCGATGGACGAC
ACTCCCGCAATGTACCGCT -> CTCCCGCAATGTACCGCTC
ACTCCGGGCATTCTGCTTT -> CTCCGGGCATTCTGCTTTG
ACTCCTATTCATCGCCAGG -> CTCCTATTCATCGCCAGGG
ACTCGAGGATCGTCTCAGG -> CTCGAGGATCGTCTCAGGG
ACTCGCGGCAGCCAAGGGA -> CTCGCGGCAGCCAAGGGAC
ACTCGTCACGATTTGTCGC -> CTCGTCACGATTTGTCGCC
ACTCTATGACTGATAGAAT -> CTCTATGACTGATAGAATT
ACTGAATCAGGCATAGGGC -> CTGAATCAGGCATAGGGCT
ACTGACGACCACCTGGGAG -> CTGACGACCACCTGGGAGT
ACTGATAGAATTCTGTAAG -> CTGATAGAATTCTGTAAGT
ACTGATAGCCCTAATGCCG -> CTGATAGCCCTAATGCCGA
ACTGCATTACCCTCTGGGG -> CTGCATTACCCTCTGGGGC
ACTTATTCCGTGGGCGCCA -> CTTATTCCGTGGGCGCCAA
ACTTCGAGCCATCTTTGGT -> CTTCGAGCCATCTTTGGTG
ACTTCGCCACTCTATGACT -> CTTCGCCACTCTATGACTG
ACTTGCGGGTAGATTTAAT -> CTTGCGGGTAGATTTAATC
ACTTGGTATGACGCTTGCA -> CTTGGTATGACGCTTGCAA
ACTTGTAATTCAAGCCTCT -> CTTGTAATTCAAGCCTCTC
AGAAACCGGCCTACCAGGA -> GAAACCGGCCTACCAGGAA
AGAAAGAAGCGGACACTCG -> GAAAGAAGCGGACACTCGC
AGAACGCGGACTTCGCCAC -> GAACGCGGACTTCGCCACT
AGAAGCGGACACTCGCGGC -> GAAGCGGACACTCGCGGCA
AGAAGCGGTTTTGCGGGTA -> GAAGCGGTTTTGCGGGTAG
AGAATGCATTCCGCGGGCT -> GAATGCATTCCGCGGGCTT
AGAATTCTGTAAGTAAACG -> GAATTCTGTAAGTAAACGT
AGACAAATACCGACATTTA -> GACAAATACCGACATTTAG
AGACAAGGAAGGTAGTCCC -> GACAAGGAAGGTAGTCCCT
AGACATCTTGGCGACCACT -> GACATCTTGGCGACCACTC
AGACCCGCCGTAGTCATAC -> GACCCGCCGTAGTCATACT
AGACGGCAATTGCATAGTT -> GACGGCAATTGCATAGTTG
AGACGTAGTATTGATACCC -> GACGTAGTATTGATACCCA
AGACGTGCCACTATGAGCT -> GACGTGCCACTATGAGCTT
AGACTAGCCTACAAAGGTA -> GACTAGCCTACAAAGGTAA
AGAGAGAGTGTGAGGTCAA -> GAGAGAGTGTGAGGTCAAC
AGAGAGTGTGAGGTCAACT -> GAGAGTGTGAGGTCAACTA
AGAGATACTCCTATTCATC -> GAGATACTCCTATTCATCG
AGAGCCTGAATTAGGAACA -> GAGCCTGAATTAGGAACAG
AGAGCGTGTTGGTCAAAAA -> GAGCGTGTTGGTCAAAAAC
AGAGGGGGTTTAATTGAGC -> GAGGGGGTTTAATTGAGCT
AGAGTGTGAGGTCAACTAC -> GAGTGTGAGGTCAACTACC
AGATAATCTCTACCAGGCC -> GATAATCTCTACCAGGCCT
AGATACTCCTATTCATCGC -> GATACTCCTATTCATCGCC
AGATATAAGTGATAAGGAC -> GATATAAGTGATAAGGACT
AGATCATCGGCTATGAAGA -> GATCATCGGCTATGAAGAC
AGATGCAGTATACGTAGGC -> GATGCAGTATACGTAGGCG
AGATTTAATCTCCCACCCG -> GATTTAATCTCCCACCCGC
AGATTTAATCTCCCACGAG -> GATTTAATCTCCCACGAGC
AGATTTAATCTCCCCGATT -> GATTTAATCTCCCCGATTC
AGATTTAATCTCCTCCGAC -> GATTTAATCTCCTCCGACG
AGATTTATGAACACGCCCC -> GATTTATGAACACGCCCCA
AGCAAGATTTATGAACACG -> GCAAGATTTATGAACACGC
AGCAATGGTTTCCGCCTTC -> GCAATGGTTTCCGCCTTCG
AGCACGTACTAGCTTAATC -> GCACGTACTAGCTTAATCA
AGCACTACCACCCAATAAT -> GCACTACCACCCAATAATA
AGCAGGGCAGTTGGATGGA -> GCAGGGCAGTTGGATGGAA
AGCAGGTCCCCACTTCGAG -> GCAGGTCCCCACTTCGAGC
AGCATTTTGAGTTTTGAAG -> GCATTTTGAGTTTTGAAGA
AGCCAAGATATAAGTGATA -> GCCAAGATATAAGTGATAA
AGCCAAGGGACATCTCCAG -> GCCAAGGGACATCTCCAGC
AGCCACGTCTTACGGCCAC -> GCCACGTCTTACGGCCACC
AGCCATCTTTGGTGACGGT -> GCCATCTTTGGTGACGGTT
AGCCCAGAGATACTCCTAT -> GCCCAGAGATACTCCTATT
AGCCCGGGATGTGGGTATA -> GCCCGGGATGTGGGTATAC
AGCCCGTAGCGTGATTATG -> GCCCGTAGCGTGATTATGG
AGCCCTAATGCCGATCGTC -> GCCCTAATGCCGATCGTCA
AGCCTAAATTCGTCCAGAC -> GCCTAAATTCGTCCAGACA
AGCCTACAAAGGTAAATTA -> GCCTACAAAGGTAAATTAG
AGCCTCTCCCAGTTTTCGG -> GCCTCTCCCAGTTTTCGGA
AGCCTGAAGACGTGCCACT -> GCCTGAAGACGTGCCACTA
AGCCTGAATTAGGAACAGT -> GCCTGAATTAGGAACAGTG
AGCGAGTGCGGGTAGATTT -> GCGAGTGCGGGTAGATTTA
AGCGCGTACTATGGTACTG -> GCGCGTACTATGGTACTGA
AGCGGAAGCTAACAACAAG -> GCGGAAGCTAACAACAAGT
AGCGGACACTCGCGGCAGC -> GCGGACACTCGCGGCAGCC
AGCGGATCGTCTTTCAAAC -> GCGGATCGTCTTTCAAACT
AGCGGCGATACTTATTCCG -> GCGGCGATACTTATTCCGT
AGCGGTTTTGCGGGTAGAT -> GCGGTTTTGCGGGTAGATT
AGCGTCCCACGCGTACCCC -> GCGTCCCACGCGTACCCCG
AGCGTGATTATGGACAAGA -> GCGTGATTATGGACAAGAA
AGCGTGTTGGTCAAAAACC -> GCGTGTTGGTCAAAAACCA
AGCTAACAACAAGTAATTT -> GCTAACAACAAGTAATTTA
AGCTAACAACAAGTACCCA -> GCTAACAACAAGTACCCAA
AGCTAACAACAAGTAGAAG -> GCTAACAACAAGTAGAAGC
AGCTAACAACAAGTATACC -> GCTAACAACAAGTATACCT
AGCTCAACGCTATGCCGGA -> GCTCAACGCTATGCCGGAA
AGCTCCATATCACTCACTA -> GCTCCATATCACTCACTAG
AGCTCTGAGTAGAGCGTGT -> GCTCTGAGTAGAGCGTGTT
AGCTGCATTTCGGGTTCGT -> GCTGCATTTCGGGTTCGTT
AGCTGTCTACGATACTATA -> GCTGTCTACGATACTATAG
AGCTTAATCAGATGCAGTA -> GCTTAATCAGATGCAGTAT
AGCTTCGCTAGCTCAACGC -> GCTTCGCTAGCTCAACGCT
AGCTTGATGTTGCTTGTTT -> GCTTGATGTTGCTTGTTTC
AGGAACAGTGATGGATGCG -> GGAACAGTGATGGATGCGG
AGGAAGCTAACAACAAGTA -> GGAAGCTAACAACAAGTAA
AGGAAGGTAGTCCCTCGTT -> GGAAGGTAGTCCCTCGTTG
AGGACGGGTAGCCCGGGAT -> GGACGGGTAGCCCGGGATG
AGGACTCCGGGCATTCTGC -> GGACTCCGGGCATTCTGCT
AGGAGGGCGGTCGTCCGCC -> GGAGGGCGGTCGTCCGCCC
AGGATCGTCTCAGGGTGCC -> GGATCGTCTCAGGGTGCCT
AGGCATAGGGCTGATGCGG -> GGCATAGGGCTGATGCGGT
AGGCCACGATACGGGGAAC -> GGCCACGATACGGGGAACC
AGGCCTCCCTCTTAGCACG -> GGCCTCCCTCTTAGCACGT
AGGCGACGGAAGTCTAGCC -> GGCGACGGAAGTCTAGCCT
AGGCGAGGGAAGGGCAATC -> GGCGAGGGAAGGGCAATCA
AGGCGGTAGGGAAGCTAAC -> GGCGGTAGGGAAGCTAACA
AGGGAAGCTAACAACAAGT -> GGGAAGCTAACAACAAGTA
AGGGAAGGGCAATCAATGG -> GGGAAGGGCAATCAATGGC
AGGGACATCTCCAGCGCGT -> GGGACATCTCCAGCGCGTA
AGGGATGGAGCCACGTCTT -> GGGATGGAGCCACGTCTTA
AGGGCAATCAATGGCCTCT -> GGGCAATCAATGGCCTCTA
AGGGCAGTTGGATGGAACG -> GGGCAGTTGGATGGAACGT
AGGGCCGGGCACGTAAGCT -> GGGCCGGGCACGTAAGCTT
AGGGCCTCCGTGCCGAATG -> GGGCCTCCGTGCCGAATGT
AGGGCGGTCGTCCGCCCCG -> GGGCGGTCGTCCGCCCCGA
AGGGCTGATGCGGTAGGGT -> GGGCTGATGCGGTAGGGTT
AGGGGCCAGCGGAAGCTAA -> GGGGCCAGCGGAAGCTAAC
AGGGGGTTTAATTGAGCTC -> GGGGGTTTAATTGAGCTCT
AGGGTGCCTGACTTGTAAT -> GGGTGCCTGACTTGTAATT
AGGGTTCAACAAGCAGGTC -> GGGTTCAACAAGCAGGTCC
AGGTACTCATATTCACAGC -> GGTACTCATATTCACAGCC
AGGTAGGGCCGGGCACGTA -> GGTAGGGCCGGGCACGTAA
AGGTAGTCCCTCGTTGATG -> GGTAGTCCCTCGTTGATGA
AGGTCAACTACCTGGAAAA -> GGTCAACTACCTGGAAAAG
AGGTCACCATACCAGTTCT -> GGTCACCATACCAGTTCTC
AGGTCCCCACTTCGAGCCA -> GGTCCCCACTTCGAGCCAT
AGGTCGGTGAGCATTTTGA -> GGTCGGTGAGCATTTTGAG
AGTAAACGTTACAAAAAGC -> GTAAACGTTACAAAAAGCA
AGTAATTTAGCGAGTGCGG -> GTAATTTAGCGAGTGCGGG
AGTACCCAAAAACTTGCGG -> GTACCCAAAAACTTGCGGG
AGTACGTTTCCCCTTGAAT -> GTACGTTTCCCCTTGAATG
AGTAGAAGCGGTTTTGCGG -> GTAGAAGCGGTTTTGCGGG
AGTAGAGCGTGTTGGTCAA -> GTAGAGCGTGTTGGTCAAA
AGTAGGAGGGCGGTCGTCC -> GTAGGAGGGCGGTCGTCCG
AGTATACCTGGCTATGCGG -> GTATACCTGGCTATGCGGG
AGTATACGTAGGCGAGGGA -> GTATACGTAGGCGAGGGAA
AGTATAGATCATCGGCTAT -> GTATAGATCATCGGCTATG
AGTATTGATACCCAATTTG -> GTATTGATACCCAATTTGT
AGTCATACTACTGCATTAC -> GTCATACTACTGCATTACC
AGTCCACAATCTCGTATTC -> GTCCACAATCTCGTATTCT
AGTCCCTCGTTGATGAGTG -> GTCCCTCGTTGATGAGTGG
AGTCGAGACGTAGTATTGA -> GTCGAGACGTAGTATTGAT
AGTCTAGCCTAAATTCGTC -> GTCTAGCCTAAATTCGTCC
AGTCTAGGTCACCATACCA -> GTCTAGGTCACCATACCAG
AGTGATAAGGACTCCGGGC -> GTGATAAGGACTCCGGGCA
AGTGATGGATGCGGGTACC -> GTGATGGATGCGGGTACCG
AGTGCGGGTAGATTTAATC -> GTGCGGGTAGATTTAATCT
AGTGGCGTGCTACCTCTTG -> GTGGCGTGCTACCTCTTGC
AGTGTGAGGTCAACTACCT -> GTGTGAGGTCAACTACCTG
AGTGTGCCCCAGTACGTTT -> GTGTGCCCCAGTACGTTTC
AGTTCGATGGACGACCGAT -> GTTCGATGGACGACCGATC
AGTTCTCTATTGAGTCGAG -> GTTCTCTATTGAGTCGAGA
AGTTGCCGCGGACAAATGG -> GTTGCCGCGGACAAATGGT
AGTTGGACGATAGCAATGG -> GTTGGACGATAGCAATGGT
AGTTGGATGGAACGTGGAA -> GTTGGATGGAACGTGGAAA
AGTTGTCGCCCAATTCACC -> GTTGTCGCCCAATTCACCC
AGTTTAAGTTGGACGATAG -> GTTTAAGTTGGACGATAGC
AGTTTTCGGAGGGATGGAG -> GTTTTCGGAGGGATGGAGC
AGTTTTGAAGACTAGCCTA -> GTTTTGAAGACTAGCCTAC
ATAAAGCTGCATTTCGGGT -> TAAAGCTGCATTTCGGGTT
ATAAGGACTCCGGGCATTC -> TAAGGACTCCGGGCATTCT
ATAAGTGATAAGGACTCCG -> TAAGTGATAAGGACTCCGG
ATAATAAAGCTGCATTTCG -> TAATAAAGCTGCATTTCGG
ATAATCGATAGCGGATCGT -> TAATCGATAGCGGATCGTC
ATAATCTCTACCAGGCCTC -> TAATCTCTACCAGGCCTCC
ATACATCTTAGGCGACGGA -> TACATCTTAGGCGACGGAA
ATACCAGTTCTCTATTGAG -> TACCAGTTCTCTATTGAGT
ATACCCAATTTGTTAGCTG -> TACCCAATTTGTTAGCTGT
ATACCGACATTTAGTTGTC -> TACCGACATTTAGTTGTCG
ATACCTGGCTATGCGGGTA -> TACCTGGCTATGCGGGTAG
ATACGGGGAACCCACCACT -> TACGGGGAACCCACCACTC
ATACGTAGGCGAGGGAAGG -> TACGTAGGCGAGGGAAGGG
ATACTACTGCATTACCCTC -> TACTACTGCATTACCCTCT
ATACTATAGCGGCGATACT -> TACTATAGCGGCGATACTT
ATACTCCTATTCATCGCCA -> TACTCCTATTCATCGCCAG
ATACTTATTCCGTGGGCGC -> TACTTATTCCGTGGGCGCC
ATAGAATTCTGTAAGTAAA -> TAGAATTCTGTAAGTAAAC
ATAGATCATCGGCTATGAA -> TAGATCATCGGCTATGAAG
ATAGCAATGGTTTCCGCCT -> TAGCAATGGTTTCCGCCTT
ATAGCCCTAATGCCGATCG -> TAGCCCTAATGCCGATCGT
ATAGCGGATCGTCTTTCAA -> TAGCGGATCGTCTTTCAAA
ATAGCGGCGATACTTATTC -> TAGCGGCGATACTTATTCC
ATAGGGCTGATGCGGTAGG -> TAGGGCTGATGCGGTAGGG
ATAGTTGCCGCGGACAAAT -> TAGTTGCCGCGGACAAATG
ATATAAGTGATAAGGACTC -> TATAAGTGATAAGGACTCC
ATATCACTCACTAGCGTCC -> TATCACTCACTAGCGTCCC
ATATCGGGGGGCCAGAGGG -> TATCGGGGGGCCAGAGGGG
ATATTCACAGCCCGTAGCG -> TATTCACAGCCCGTAGCGT
ATATTGCCGTTCGAAGTCT -> TATTGCCGTTCGAAGTCTA
ATCAATGGCCTCTAGGTCG -> TCAATGGCCTCTAGGTCGG
ATCACATGTGCTATTAAGG -> TCACATGTGCTATTAAGGT
ATCACTCACTAGCGTCCCA -> TCACTCACTAGCGTCCCAC
ATCAGATGCAGTATACGTA -> TCAGATGCAGTATACGTAG
ATCAGGCATAGGGCTGATG -> TCAGGCATAGGGCTGATGC
ATCAGTGTGCCCCAGTACG -> TCAGTGTGCCCCAGTACGT
ATCATCGGCTATGAAGACC -> TCATCGGCTATGAAGACCC
ATCCCCTGGCATAATCGAT -> TCCCCTGGCATAATCGATA
ATCCGCCAATGCCCCTCGC -> TCCGCCAATGCCCCTCGCT
ATCCTTCCCGAATGGGCCA -> TCCTTCCCGAATGGGCCAA
ATCGATAGCGGATCGTCTT -> TCGATAGCGGATCGTCTTT
ATCGCCAGGGGCCAGCGGA -> TCGCCAGGGGCCAGCGGAA
ATCGGCTATGAAGACCCGC -> TCGGCTATGAAGACCCGCC
ATCGGGGGGCCAGAGGGGG -> TCGGGGGGCCAGAGGGGGT
ATCGTCAGCAGGGCAGTTG -> TCGTCAGCAGGGCAGTTGG
ATCGTCTCAGGGTGCCTGA -> TCGTCTCAGGGTGCCTGAC
ATCGTCTTTCAAACTGAAT -> TCGTCTTTCAAACTGAATC
ATCTACATATTGCCGTTCG -> TCTACATATTGCCGTTCGA
ATCTACGCACCTCTTAAGA -> TCTACGCACCTCTTAAGAC
ATCTCCAGCGCGTACTATG -> TCTCCAGCGCGTACTATGG
ATCTCCCACCCGCTCCGAT -> TCTCCCACCCGCTCCGATC
ATCTCCCACGAGCCCAGAG -> TCTCCCACGAGCCCAGAGA
ATCTCCCCGATTCATCTAC -> TCTCCCCGATTCATCTACG
ATCTCCTCCGACGGAAGAA -> TCTCCTCCGACGGAAGAAC
ATCTCGTATTCTGCATCAG -> TCTCGTATTCTGCATCAGT
ATCTCTACCAGGCCTCCCT -> TCTCTACCAGGCCTCCCTC
ATCTGCATCTACATATTGC -> TCTGCATCTACATATTGCC
ATCTGGTTAATTGACCCCG -> TCTGGTTAATTGACCCCGA
ATCTTAGGCGACGGAAGTC -> TCTTAGGCGACGGAAGTCT
ATCTTGGCGACCACTCCAG -> TCTTGGCGACCACTCCAGT
ATCTTTGGTGACGGTTACA -> TCTTTGGTGACGGTTACAA
ATGAAATCTGGTTAATTGA -> TGAAATCTGGTTAATTGAC
ATGAACACGCCCCAGTCCA -> TGAACACGCCCCAGTCCAC
ATGAAGACCCGCCGTAGTC -> TGAAGACCCGCCGTAGTCA
ATGAAGTTTAAGTTGGACG -> TGAAGTTTAAGTTGGACGA
ATGACGCTTGCAAGGCGGT -> TGACGCTTGCAAGGCGGTA
ATGACTGATAGAATTCTGT -> TGACTGATAGAATTCTGTA
ATGAGCTTCGCTAGCTCAA -> TGAGCTTCGCTAGCTCAAC
ATGAGTGGCGTGCTACCTC -> TGAGTGGCGTGCTACCTCT
ATGCAGTATACGTAGGCGA -> TGCAGTATACGTAGGCGAG
ATGCATTCCGCGGGCTTAC -> TGCATTCCGCGGGCTTACG
ATGCCAAGAATGCATTCCG -> TGCCAAGAATGCATTCCGC
ATGCCCCTCGCTGCGTCGA -> TGCCCCTCGCTGCGTCGAA
ATGCCGATCGTCAGCAGGG -> TGCCGATCGTCAGCAGGGC
ATGCCGGAAAGACATCTTG -> TGCCGGAAAGACATCTTGG
ATGCCTTTAGAAACCGGCC -> TGCCTTTAGAAACCGGCCT
ATGCGGGTACCGACAATTT -> TGCGGGTACCGACAATTTA
ATGCGGGTAGATTTAATCT -> TGCGGGTAGATTTAATCTC
ATGCGGTAGGGTTCAACAA -> TGCGGTAGGGTTCAACAAG
ATGCTTTCCCGAGAGAGAG -> TGCTTTCCCGAGAGAGAGT
ATGGAACGTGGAAAAGCTC -> TGGAACGTGGAAAAGCTCC
ATGGACAAGAAAGAAGCGG -> TGGACAAGAAAGAAGCGGA
ATGGACGACCGATCCTTCC -> TGGACGACCGATCCTTCCC
ATGGAGCCACGTCTTACGG -> TGGAGCCACGTCTTACGGC
ATGGATGCGGGTACCGACA -> TGGATGCGGGTACCGACAA
ATGGCCTCTAGGTCGGTGA -> TGGCCTCTAGGTCGGTGAG
ATGGGCCAAATTTCTGAAC -> TGGGCCAAATTTCTGAACG
ATGGGCTAGACAAATACCG -> TGGGCTAGACAAATACCGA
ATGGTACTGACGACCACCT -> TGGTACTGACGACCACCTG
ATGGTAGCCAAGATATAAG -> TGGTAGCCAAGATATAAGT
ATGGTGCTACTTGGTATGA -> TGGTGCTACTTGGTATGAC
ATGGTTTCCGCCTTCGGTT -> TGGTTTCCGCCTTCGGTTC
ATGTACCGCTCCTGCAAAA -> TGTACCGCTCCTGCAAAAG
ATGTGCTATTAAGGTACTC -> TGTGCTATTAAGGTACTCA
ATGTGGGTATACATCTTAG -> TGTGGGTATACATCTTAGG
ATGTTCGCCAGCCTGAAGA -> TGTTCGCCAGCCTGAAGAC
ATGTTGCTTGTTTCTCGCC -> TGTTGCTTGTTTCTCGCCA
ATTAAGGTACTCATATTCA -> TTAAGGTACTCATATTCAC
ATTACCAGGACGGGTAGCC -> TTACCAGGACGGGTAGCCC
ATTACCCTCTGGGGCACCA -> TTACCCTCTGGGGCACCAA
ATTAGGAACAGTGATGGAT -> TTAGGAACAGTGATGGATG
ATTATGGACAAGAAAGAAG -> TTATGGACAAGAAAGAAGC
ATTCAAGCCTCTCCCAGTT -> TTCAAGCCTCTCCCAGTTT
ATTCACAGCCCGTAGCGTG -> TTCACAGCCCGTAGCGTGA
ATTCACCCGGCGCCTCTGG -> TTCACCCGGCGCCTCTGGC
ATTCACTCGAGGATCGTCT -> TTCACTCGAGGATCGTCTC
ATTCAGGGCCTCCGTGCCG -> TTCAGGGCCTCCGTGCCGA
ATTCATCGCCAGGGGCCAG -> TTCATCGCCAGGGGCCAGC
ATTCATCTACGCACCTCTT -> TTCATCTACGCACCTCTTA
ATTCCGCGGGCTTACGACA -> TTCCGCGGGCTTACGACAC
ATTCCGTGGGCGCCAAAGG -> TTCCGTGGGCGCCAAAGGT
ATTCGTCCAGACAAGGAAG -> TTCGTCCAGACAAGGAAGG
ATTCTGCATCAGTGTGCCC -> TTCTGCATCAGTGTGCCCC
ATTCTGCTTTGGAAGCTAA -> TTCTGCTTTGGAAGCTAAC
ATTCTGTAAGTAAACGTTA -> TTCTGTAAGTAAACGTTAC
ATTGACCCCGATCACATGT -> TTGACCCCGATCACATGTG
ATTGAGCTCTGAGTAGAGC -> TTGAGCTCTGAGTAGAGCG
ATTGAGTCGAGACGTAGTA -> TTGAGTCGAGACGTAGTAT
ATTGATACCCAATTTGTTA -> TTGATACCCAATTTGTTAG
ATTGCATAGTTGCCGCGGA -> TTGCATAGTTGCCGCGGAC
ATTGCCGTTCGAAGTCTAG -> TTGCCGTTCGAAGTCTAGG
ATTGGTAATATCGGGGGGC -> TTGGTAATATCGGGGGGCC
ATTTAATCTCCCACCCGCT -> TTTAATCTCCCACCCGCTC
ATTTAATCTCCCACGAGCC -> TTTAATCTCCCACGAGCCC
ATTTAATCTCCCCGATTCA -> TTTAATCTCCCCGATTCAT
ATTTAATCTCCTCCGACGG -> TTTAATCTCCTCCGACGGA
ATTTAGCAAGATTTATGAA -> TTTAGCAAGATTTATGAAC
ATTTAGCGAGTGCGGGTAG -> TTTAGCGAGTGCGGGTAGA
ATTTAGTTGTCGCCCAATT -> TTTAGTTGTCGCCCAATTC
ATTTATGAACACGCCCCAG -> TTTATGAACACGCCCCAGT
ATTTATTCAGGGCCTCCGT -> TTTATTCAGGGCCTCCGTG
ATTTCGGGTTCGTTTATGA -> TTTCGGGTTCGTTTATGAA
ATTTCTGAACGGTACTATC -> TTTCTGAACGGTACTATCC
ATTTGTCGCCCTTTGTACC -> TTTGTCGCCCTTTGTACCC
ATTTGTTAGCTGTCTACGA -> TTTGTTAGCTGTCTACGAT
ATTTTGAGTTTTGAAGACT -> TTTTGAGTTTTGAAGACTA
CAAAAACCACTGATAGCCC -> AAAAACCACTGATAGCCCT
CAAAAACTTGCGGGTAGAT -> AAAAACTTGCGGGTAGATT
CAAAAAGCACTACCACCCA -> AAAAAGCACTACCACCCAA
CAAAAGATAATCTCTACCA -> AAAAGATAATCTCTACCAG
CAAAAGGCCACGATACGGG -> AAAAGGCCACGATACGGGG
CAAACTGAATCAGGCATAG -> AAACTGAATCAGGCATAGG
CAAAGGTAAATTAGAGTGA -> AAAGGTAAATTAGAGTGAA
CAAAGGTAGGGCCGGGCAC -> AAAGGTAGGGCCGGGCACG
CAAATACCGACATTTAGTT -> AAATACCGACATTTAGTTG
CAAATGGTGCTACTTGGTA -> AAATGGTGCTACTTGGTAT
CAAATTTCTGAACGGTACT -> AAATTTCTGAACGGTACTA
CAACAAGCAGGTCCCCACT -> AACAAGCAGGTCCCCACTT
CAACAAGTAATTTAGCGAG -> AACAAGTAATTTAGCGAGT
CAACAAGTACCCAAAAACT -> AACAAGTACCCAAAAACTT
CAACAAGTAGAAGCGGTTT -> AACAAGTAGAAGCGGTTTT
CAACAAGTATACCTGGCTA -> AACAAGTATACCTGGCTAT
CAACGCTATGCCGGAAAGA -> AACGCTATGCCGGAAAGAC
CAACTACCTGGAAAAGAGC -> AACTACCTGGAAAAGAGCC
CAAGAAAGAAGCGGACACT -> AAGAAAGAAGCGGACACTC
CAAGAATGCATTCCGCGGG -> AAGAATGCATTCCGCGGGC
CAAGATATAAGTGATAAGG -> AAGATATAAGTGATAAGGA
CAAGATTTATGAACACGCC -> AAGATTTATGAACACGCCC
CAAGCAGGTCCCCACTTCG -> AAGCAGGTCCCCACTTCGA
CAAGCCTCTCCCAGTTTTC -> AAGCCTCTCCCAGTTTTCG
CAAGGAAGGTAGTCCCTCG -> AAGGAAGGTAGTCCCTCGT
CAAGGCGGTAGGGAAGCTA -> AAGGCGGTAGGGAAGCTAA
CAAGGGACATCTCCAGCGC -> AAGGGACATCTCCAGCGCG
CAAGTAATTTAGCGAGTGC -> AAGTAATTTAGCGAGTGCG
CAAGTACCCAAAAACTTGC -> AAGTACCCAAAAACTTGCG
CAAGTAGAAGCGGTTTTGC -> AAGTAGAAGCGGTTTTGCG
CAAGTATACCTGGCTATGC -> AAGTATACCTGGCTATGCG
CAATAATAAAGCTGCATTT -> AATAATAAAGCTGCATTTC
CAATCAATGGCCTCTAGGT -> AATCAATGGCCTCTAGGTC
CAATCTCGTATTCTGCATC -> AATCTCGTATTCTGCATCA
CAATCTGCATCTACATATT -> AATCTGCATCTACATATTG
CAATGCCCCTCGCTGCGTC -> AATGCCCCTCGCTGCGTCG
CAATGCCTTTAGAAACCGG -> AATGCCTTTAGAAACCGGC
CAATGGCCTCTAGGTCGGT -> AATGGCCTCTAGGTCGGTG
CAATGGTTTCCGCCTTCGG -> AATGGTTTCCGCCTTCGGT
CAATGTACCGCTCCTGCAA -> AATGTACCGCTCCTGCAAA
CAATTCACCCGGCGCCTCT -> AATTCACCCGGCGCCTCTG
CAATTGCATAGTTGCCGCG -> AATTGCATAGTTGCCGCGG
CAATTTAGCAAGATTTATG -> AATTTAGCAAGATTTATGA
CAATTTGTTAGCTGTCTAC -> AATTTGTTAGCTGTCTACG
CACAATCTCGTATTCTGCA -> ACAATCTCGTATTCTGCAT
CACAGCCCGTAGCGTGATT -> ACAGCCCGTAGCGTGATTA
CACATGTGCTATTAAGGTA -> ACATGTGCTATTAAGGTAC
CACCAATCTGCATCTACAT -> ACCAATCTGCATCTACATA
CACCACTCGTCACGATTTG -> ACCACTCGTCACGATTTGT
CACCATACCAGTTCTCTAT -> ACCATACCAGTTCTCTATT
CACCCAATAATAAAGCTGC -> ACCCAATAATAAAGCTGCA
CACCCGCTCCGATCCGCCA -> ACCCGCTCCGATCCGCCAA
CACCCGGCGCCTCTGGCCG -> ACCCGGCGCCTCTGGCCGA
CACCGAACTCCCGCAATGT -> ACCGAACTCCCGCAATGTA
CACCTCACTATTGGTAATA -> ACCTCACTATTGGTAATAT
CACCTCTTAAGACGGCAAT -> ACCTCTTAAGACGGCAATT
CACCTGGGAGTATAGATCA -> ACCTGGGAGTATAGATCAT
CACGAGCCCAGAGATACTC -> ACGAGCCCAGAGATACTCC
CACGATACGGGGAACCCAC -> ACGATACGGGGAACCCACC
CACGATTTGTCGCCCTTTG -> ACGATTTGTCGCCCTTTGT
CACGCCCCAGTCCACAATC -> ACGCCCCAGTCCACAATCT
CACGCGTACCCCGATGCCA -> ACGCGTACCCCGATGCCAA
CACGGCTCATTACCAGGAC -> ACGGCTCATTACCAGGACG
CACGTAAGCTTGATGTTGC -> ACGTAAGCTTGATGTTGCT
CACGTACTAGCTTAATCAG -> ACGTACTAGCTTAATCAGA
CACGTCTTACGGCCACCTC -> ACGTCTTACGGCCACCTCA
CACTACCACCCAATAATAA -> ACTACCACCCAATAATAAA
CACTAGCGTCCCACGCGTA -> ACTAGCGTCCCACGCGTAC
CACTATGAGCTTCGCTAGC -> ACTATGAGCTTCGCTAGCT
CACTATTGGTAATATCGGG -> ACTATTGGTAATATCGGGG
CACTCACTAGCGTCCCACG -> ACTCACTAGCGTCCCACGC
CACTCCAGTTCGATGGACG -> ACTCCAGTTCGATGGACGA
CACTCGAGGATCGTCTCAG -> ACTCGAGGATCGTCTCAGG
CACTCGCGGCAGCCAAGGG -> ACTCGCGGCAGCCAAGGGA
CACTCGTCACGATTTGTCG -> ACTCGTCACGATTTGTCGC
CACTCTATGACTGATAGAA -> ACTCTATGACTGATAGAAT
CACTGATAGCCCTAATGCC -> ACTGATAGCCCTAATGCCG
CACTTCGAGCCATCTTTGG -> ACTTCGAGCCATCTTTGGT
CAGACAAGGAAGGTAGTCC -> AGACAAGGAAGGTAGTCCC
CAGAGATACTCCTATTCAT -> AGAGATACTCCTATTCATC
CAGAGGGGGTTTAATTGAG -> AGAGGGGGTTTAATTGAGC
CAGATGCAGTATACGTAGG -> AGATGCAGTATACGTAGGC
CAGCAGGGCAGTTGGATGG -> AGCAGGGCAGTTGGATGGA
CAGCCAAGGGACATCTCCA -> AGCCAAGGGACATCTCCAG
CAGCCCGTAGCGTGATTAT -> AGCCCGTAGCGTGATTATG
CAGCCTGAAGACGTGCCAC -> AGCCTGAAGACGTGCCACT
CAGCGCGTACTATGGTACT -> AGCGCGTACTATGGTACTG
CAGCGGAAGCTAACAACAA -> AGCGGAAGCTAACAACAAG
CAGGAAGCTAACAACAAGT -> AGGAAGCTAACAACAAGTA
CAGGACGGGTAGCCCGGGA -> AGGACGGGTAGCCCGGGAT
CAGGCATAGGGCTGATGCG -> AGGCATAGGGCTGATGCGG
CAGGCCTCCCTCTTAGCAC -> AGGCCTCCCTCTTAGCACG
CAGGGCAGTTGGATGGAAC -> AGGGCAGTTGGATGGAACG
CAGGGCCTCCGTGCCGAAT -> AGGGCCTCCGTGCCGAATG
CAGGGGCCAGCGGAAGCTA -> AGGGGCCAGCGGAAGCTAA
CAGGGTGCCTGACTTGTAA -> AGGGTGCCTGACTTGTAAT
CAGGTCCCCACTTCGAGCC -> AGGTCCCCACTTCGAGCCA
CAGTACGTTTCCCCTTGAA -> AGTACGTTTCCCCTTGAAT
CAGTATACGTAGGCGAGGG -> AGTATACGTAGGCGAGGGA
CAGTCCACAATCTCGTATT -> AGTCCACAATCTCGTATTC
CAGTGATGGATGCGGGTAC -> AGTGATGGATGCGGGTACC
CAGTGTGCCCCAGTACGTT -> AGTGTGCCCCAGTACGTTT
CAGTTCGATGGACGACCGA -> AGTTCGATGGACGACCGAT
CAGTTCTCTATTGAGTCGA -> AGTTCTCTATTGAGTCGAG
CAGTTGGATGGAACGTGGA -> AGTTGGATGGAACGTGGAA
CAGTTTTCGGAGGGATGGA -> AGTTTTCGGAGGGATGGAG
CATAATCGATAGCGGATCG -> ATAATCGATAGCGGATCGT
CATACCAGTTCTCTATTGA -> ATACCAGTTCTCTATTGAG
CATACTACTGCATTACCCT -> ATACTACTGCATTACCCTC
CATAGGGCTGATGCGGTAG -> ATAGGGCTGATGCGGTAGG
CATAGTTGCCGCGGACAAA -> ATAGTTGCCGCGGACAAAT
CATATCACTCACTAGCGTC -> ATATCACTCACTAGCGTCC
CATATTCACAGCCCGTAGC -> ATATTCACAGCCCGTAGCG
CATATTGCCGTTCGAAGTC -> ATATTGCCGTTCGAAGTCT
CATCAGTGTGCCCCAGTAC -> ATCAGTGTGCCCCAGTACG
CATCGCCAGGGGCCAGCGG -> ATCGCCAGGGGCCAGCGGA
CATCGGCTATGAAGACCCG -> ATCGGCTATGAAGACCCGC
CATCTACATATTGCCGTTC -> ATCTACATATTGCCGTTCG
CATCTACGCACCTCTTAAG -> ATCTACGCACCTCTTAAGA
CATCTCCAGCGCGTACTAT -> ATCTCCAGCGCGTACTATG
CATCTTAGGCGACGGAAGT -> ATCTTAGGCGACGGAAGTC
CATCTTGGCGACCACTCCA -> ATCTTGGCGACCACTCCAG
CATCTTTGGTGACGGTTAC -> ATCTTTGGTGACGGTTACA
CATGCTTTCCCGAGAGAGA -> ATGCTTTCCCGAGAGAGAG
CATGGTAGCCAAGATATAA -> ATGGTAGCCAAGATATAAG
CATGTGCTATTAAGGTACT -> ATGTGCTATTAAGGTACTC
CATTACCAGGACGGGTAGC -> ATTACCAGGACGGGTAGCC
CATTACCCTCTGGGGCACC -> ATTACCCTCTGGGGCACCA
CATTCCGCGGGCTTACGAC -> ATTCCGCGGGCTTACGACA
CATTCTGCTTTGGAAGCTA -> ATTCTGCTTTGGAAGCTAA
CATTTAGTTGTCGCCCAAT -> ATTTAGTTGTCGCCCAATT
CATTTATTCAGGGCCTCCG -> ATTTATTCAGGGCCTCCGT
CATTTCGGGTTCGTTTATG -> ATTTCGGGTTCGTTTATGA
CATTTTGAGTTTTGAAGAC -> ATTTTGAGTTTTGAAGACT
CCAAAAACTTGCGGGTAGA -> CAAAAACTTGCGGGTAGAT
CCAAAGGTAGGGCCGGGCA -> CAAAGGTAGGGCCGGGCAC
CCAAATTTCTGAACGGTAC -> CAAATTTCTGAACGGTACT
CCAAGAATGCATTCCGCGG -> CAAGAATGCATTCCGCGGG
CCAAGATATAAGTGATAAG -> CAAGATATAAGTGATAAGG
CCAAGGGACATCTCCAGCG -> CAAGGGACATCTCCAGCGC
CCAATAATAAAGCTGCATT -> CAATAATAAAGCTGCATTT
CCAATCTGCATCTACATAT -> CAATCTGCATCTACATATT
CCAATGCCCCTCGCTGCGT -> CAATGCCCCTCGCTGCGTC
CCAATGCCTTTAGAAACCG -> CAATGCCTTTAGAAACCGG
CCAATTCACCCGGCGCCTC -> CAATTCACCCGGCGCCTCT
CCAATTTGTTAGCTGTCTA -> CAATTTGTTAGCTGTCTAC
CCACAATCTCGTATTCTGC -> CACAATCTCGTATTCTGCA
CCACCACTCGTCACGATTT -> CACCACTCGTCACGATTTG
CCACCCAATAATAAAGCTG -> CACCCAATAATAAAGCTGC
CCACCCGCTCCGATCCGCC -> CACCCGCTCCGATCCGCCA
CCACCTCACTATTGGTAAT -> CACCTCACTATTGGTAATA
CCACCTGGGAGTATAGATC -> CACCTGGGAGTATAGATCA
CCACGAGCCCAGAGATACT -> CACGAGCCCAGAGATACTC
CCACGATACGGGGAACCCA -> CACGATACGGGGAACCCAC
CCACGCGTACCCCGATGCC -> CACGCGTACCCCGATGCCA
CCACGGCTCATTACCAGGA -> CACGGCTCATTACCAGGAC
CCACGTCTTACGGCCACCT -> CACGTCTTACGGCCACCTC
CCACTATGAGCTTCGCTAG -> CACTATGAGCTTCGCTAGC
CCACTCCAGTTCGATGGAC -> CACTCCAGTTCGATGGACG
CCACTCGTCACGATTTGTC -> CACTCGTCACGATTTGTCG
CCACTCTATGACTGATAGA -> CACTCTATGACTGATAGAA
CCACTGATAGCCCTAATGC -> CACTGATAGCCCTAATGCC
CCACTTCGAGCCATCTTTG -> CACTTCGAGCCATCTTTGG
CCAGACAAGGAAGGTAGTC -> CAGACAAGGAAGGTAGTCC
CCAGAGATACTCCTATTCA -> CAGAGATACTCCTATTCAT
CCAGAGGGGGTTTAATTGA -> CAGAGGGGGTTTAATTGAG
CCAGCCTGAAGACGTGCCA -> CAGCCTGAAGACGTGCCAC
CCAGCGCGTACTATGGTAC -> CAGCGCGTACTATGGTACT
CCAGCGGAAGCTAACAACA -> CAGCGGAAGCTAACAACAA
CCAGGAAGCTAACAACAAG -> CAGGAAGCTAACAACAAGT
CCAGGACGGGTAGCCCGGG -> CAGGACGGGTAGCCCGGGA
CCAGGCCTCCCTCTTAGCA -> CAGGCCTCCCTCTTAGCAC
CCAGGGGCCAGCGGAAGCT -> CAGGGGCCAGCGGAAGCTA
CCAGTACGTTTCCCCTTGA -> CAGTACGTTTCCCCTTGAA
CCAGTCCACAATCTCGTAT -> CAGTCCACAATCTCGTATT
CCAGTTCGATGGACGACCG -> CAGTTCGATGGACGACCGA
CCAGTTCTCTATTGAGTCG -> CAGTTCTCTATTGAGTCGA
CCAGTTTTCGGAGGGATGG -> CAGTTTTCGGAGGGATGGA
CCATACCAGTTCTCTATTG -> CATACCAGTTCTCTATTGA
CCATATCACTCACTAGCGT -> CATATCACTCACTAGCGTC
CCATCTTTGGTGACGGTTA -> CATCTTTGGTGACGGTTAC
CCATGGTAGCCAAGATATA -> CATGGTAGCCAAGATATAA
CCATTTATTCAGGGCCTCC -> CATTTATTCAGGGCCTCCG
CCCAAAAACTTGCGGGTAG -> CCAAAAACTTGCGGGTAGA
CCCAATAATAAAGCTGCAT -> CCAATAATAAAGCTGCATT
CCCAATTCACCCGGCGCCT -> CCAATTCACCCGGCGCCTC
CCCAATTTGTTAGCTGTCT -> CCAATTTGTTAGCTGTCTA
CCCACCACTCGTCACGATT -> CCACCACTCGTCACGATTT
CCCACCCGCTCCGATCCGC -> CCACCCGCTCCGATCCGCC
CCCACGAGCCCAGAGATAC -> CCACGAGCCCAGAGATACT
CCCACGCGTACCCCGATGC -> CCACGCGTACCCCGATGCC
CCCACTTCGAGCCATCTTT -> CCACTTCGAGCCATCTTTG
CCCAGAGATACTCCTATTC -> CCAGAGATACTCCTATTCA
CCCAGTACGTTTCCCCTTG -> CCAGTACGTTTCCCCTTGA
CCCAGTCCACAATCTCGTA -> CCAGTCCACAATCTCGTAT
CCCAGTTTTCGGAGGGATG -> CCAGTTTTCGGAGGGATGG
CCCCACTTCGAGCCATCTT -> CCCACTTCGAGCCATCTTT
CCCCAGTACGTTTCCCCTT -> CCCAGTACGTTTCCCCTTG
CCCCAGTCCACAATCTCGT -> CCCAGTCCACAATCTCGTA
CCCCGACGGAACCATTTAT -> CCCGACGGAACCATTTATT
CCCCGATCACATGTGCTAT -> CCCGATCACATGTGCTATT
CCCCGATGCCAAGAATGCA -> CCCGATGCCAAGAATGCAT
CCCCGATTCATCTACGCAC -> CCCGATTCATCTACGCACC
CCCCTCGCTGCGTCGAAAT -> CCCTCGCTGCGTCGAAATT
CCCCTGGCATAATCGATAG -> CCCTGGCATAATCGATAGC
CCCCTTGAATGAAGTTTAA -> CCCTTGAATGAAGTTTAAG
CCCGAATGGGCCAAATTTC -> CCGAATGGGCCAAATTTCT
CCCGACGGAACCATTTATT -> CCGACGGAACCATTTATTC
CCCGAGAGAGAGTGTGAGG -> CCGAGAGAGAGTGTGAGGT
CCCGATCACATGTGCTATT -> CCGATCACATGTGCTATTA
CCCGATGCCAAGAATGCAT -> CCGATGCCAAGAATGCATT
CCCGATTCATCTACGCACC -> CCGATTCATCTACGCACCT
CCCGCAATGTACCGCTCCT -> CCGCAATGTACCGCTCCTG
CCCGCCGTAGTCATACTAC -> CCGCCGTAGTCATACTACT
CCCGCTCCGATCCGCCAAT -> CCGCTCCGATCCGCCAATG
CCCGGCGCCTCTGGCCGAC -> CCGGCGCCTCTGGCCGACC
CCCGGGATGTGGGTATACA -> CCGGGATGTGGGTATACAT
CCCGGGTTCCACGGCTCAT -> CCGGGTTCCACGGCTCATT
CCCGTAGCGTGATTATGGA -> CCGTAGCGTGATTATGGAC
CCCTAATGCCGATCGTCAG -> CCTAATGCCGATCGTCAGC
CCCTCGCTGCGTCGAAATT -> CCTCGCTGCGTCGAAATTC
CCCTCGTTGATGAGTGGCG -> CCTCGTTGATGAGTGGCGT
CCCTCTGGGGCACCAATCT -> CCTCTGGGGCACCAATCTG
CCCTCTTAGCACGTACTAG -> CCTCTTAGCACGTACTAGC
CCCTGACGGCCTGGCCCGG -> CCTGACGGCCTGGCCCGGG
CCCTGGCATAATCGATAGC -> CCTGGCATAATCGATAGCG
CCCTTGAAACATGCTTTCC -> CCTTGAAACATGCTTTCCC
CCCTTGAATGAAGTTTAAG -> CCTTGAATGAAGTTTAAGT
CCCTTTGTACCCTGACGGC -> CCTTTGTACCCTGACGGCC
CCGAACTCCCGCAATGTAC -> CGAACTCCCGCAATGTACC
CCGAATGGGCCAAATTTCT -> CGAATGGGCCAAATTTCTG
CCGAATGTTCGCCAGCCTG -> CGAATGTTCGCCAGCCTGA
CCGACAATTTAGCAAGATT -> CGACAATTTAGCAAGATTT
CCGACATTTAGTTGTCGCC -> CGACATTTAGTTGTCGCCC
CCGACCCTTGAAACATGCT -> CGACCCTTGAAACATGCTT
CCGACGGAACCATTTATTC -> CGACGGAACCATTTATTCA
CCGACGGAAGAACGCGGAC -> CGACGGAAGAACGCGGACT
CCGAGAGAGAGTGTGAGGT -> CGAGAGAGAGTGTGAGGTC
CCGATCACATGTGCTATTA -> CGATCACATGTGCTATTAA
CCGATCCGCCAATGCCCCT -> CGATCCGCCAATGCCCCTC
CCGATCCTTCCCGAATGGG -> CGATCCTTCCCGAATGGGC
CCGATCGTCAGCAGGGCAG -> CGATCGTCAGCAGGGCAGT
CCGATGCCAAGAATGCATT -> CGATGCCAAGAATGCATTC
CCGATTCATCTACGCACCT -> CGATTCATCTACGCACCTC
CCGCAATGTACCGCTCCTG -> CGCAATGTACCGCTCCTGC
CCGCCAATGCCCCTCGCTG -> CGCCAATGCCCCTCGCTGC
CCGCCCCGACGGAACCATT -> CGCCCCGACGGAACCATTT
CCGCCGTAGTCATACTACT -> CGCCGTAGTCATACTACTG
CCGCCTTCGGTTCTGCCAA -> CGCCTTCGGTTCTGCCAAT
CCGCGGACAAATGGTGCTA -> CGCGGACAAATGGTGCTAC
CCGCGGGCTTACGACACCG -> CGCGGGCTTACGACACCGA
CCGCTCCGATCCGCCAATG -> CGCTCCGATCCGCCAATGC
CCGCTCCTGCAAAAGATAA -> CGCTCCTGCAAAAGATAAT
CCGGAAAGACATCTTGGCG -> CGGAAAGACATCTTGGCGA
CCGGCCTACCAGGAAGCTA -> CGGCCTACCAGGAAGCTAA
CCGGCGCCTCTGGCCGACC -> CGGCGCCTCTGGCCGACCC
CCGGGATGTGGGTATACAT -> CGGGATGTGGGTATACATC
CCGGGCACGTAAGCTTGAT -> CGGGCACGTAAGCTTGATG
CCGGGCATTCTGCTTTGGA -> CGGGCATTCTGCTTTGGAA
CCGGGTTCCACGGCTCATT -> CGGGTTCCACGGCTCATTA
CCGTAGCGTGATTATGGAC -> CGTAGCGTGATTATGGACA
CCGTAGTCATACTACTGCA -> CGTAGTCATACTACTGCAT
CCGTGCCGAATGTTCGCCA -> CGTGCCGAATGTTCGCCAG
CCGTGGGCGCCAAAGGTAG -> CGTGGGCGCCAAAGGTAGG
CCGTTCGAAGTCTAGGTCA -> CGTTCGAAGTCTAGGTCAC
CCTAAATTCGTCCAGACAA -> CTAAATTCGTCCAGACAAG
CCTAATGCCGATCGTCAGC -> CTAATGCCGATCGTCAGCA
CCTACAAAGGTAAATTAGA -> CTACAAAGGTAAATTAGAG
CCTACCAGGAAGCTAACAA -> CTACCAGGAAGCTAACAAC
CCTATTCATCGCCAGGGGC -> CTATTCATCGCCAGGGGCC
CCTCACTATTGGTAATATC -> CTCACTATTGGTAATATCG
CCTCCCTCTTAGCACGTAC -> CTCCCTCTTAGCACGTACT
CCTCCGACGGAAGAACGCG -> CTCCGACGGAAGAACGCGG
CCTCCGTGCCGAATGTTCG -> CTCCGTGCCGAATGTTCGC
CCTCGCTGCGTCGAAATTC -> CTCGCTGCGTCGAAATTCA
CCTCGTTGATGAGTGGCGT -> CTCGTTGATGAGTGGCGTG
CCTCTAGGTCGGTGAGCAT -> CTCTAGGTCGGTGAGCATT
CCTCTCCCAGTTTTCGGAG -> CTCTCCCAGTTTTCGGAGG
CCTCTGGCCGACCCTTGAA -> CTCTGGCCGACCCTTGAAA
CCTCTGGGGCACCAATCTG -> CTCTGGGGCACCAATCTGC
CCTCTTAAGACGGCAATTG -> CTCTTAAGACGGCAATTGC
CCTCTTAGCACGTACTAGC -> CTCTTAGCACGTACTAGCT
CCTCTTGCTTGTTAAATGG -> CTCTTGCTTGTTAAATGGG
CCTGAAGACGTGCCACTAT -> CTGAAGACGTGCCACTATG
CCTGAATTAGGAACAGTGA -> CTGAATTAGGAACAGTGAT
CCTGACGGCCTGGCCCGGG -> CTGACGGCCTGGCCCGGGT
CCTGACTTGTAATTCAAGC -> CTGACTTGTAATTCAAGCC
CCTGCAAAAGATAATCTCT -> CTGCAAAAGATAATCTCTA
CCTGGAAAAGAGCCTGAAT -> CTGGAAAAGAGCCTGAATT
CCTGGCATAATCGATAGCG -> CTGGCATAATCGATAGCGG
CCTGGCCCGGGTTCCACGG -> CTGGCCCGGGTTCCACGGC
CCTGGCTATGCGGGTAGAT -> CTGGCTATGCGGGTAGATT
CCTGGGAGTATAGATCATC -> CTGGGAGTATAGATCATCG
CCTTCCCGAATGGGCCAAA -> CTTCCCGAATGGGCCAAAT
CCTTCGGTTCTGCCAATGC -> CTTCGGTTCTGCCAATGCC
CCTTGAAACATGCTTTCCC -> CTTGAAACATGCTTTCCCG
CCTTGAATGAAGTTTAAGT -> CTTGAATGAAGTTTAAGTT
CCTTTAGAAACCGGCCTAC -> CTTTAGAAACCGGCCTACC
CCTTTGTACCCTGACGGCC -> CTTTGTACCCTGACGGCCT
CGAAATTCACTCGAGGATC -> GAAATTCACTCGAGGATCG
CGAACTCCCGCAATGTACC -> GAACTCCCGCAATGTACCG
CGAAGTCTAGGTCACCATA -> GAAGTCTAGGTCACCATAC
CGAATGGGCCAAATTTCTG -> GAATGGGCCAAATTTCTGA
CGAATGTTCGCCAGCCTGA -> GAATGTTCGCCAGCCTGAA
CGACAATTTAGCAAGATTT -> GACAATTTAGCAAGATTTA
CGACACCGAACTCCCGCAA -> GACACCGAACTCCCGCAAT
CGACATTTAGTTGTCGCCC -> GACATTTAGTTGTCGCCCA
CGACCACCTGGGAGTATAG -> GACCACCTGGGAGTATAGA
CGACCACTCCAGTTCGATG -> GACCACTCCAGTTCGATGG
CGACCCTTGAAACATGCTT -> GACCCTTGAAACATGCTTT
CGACCGATCCTTCCCGAAT -> GACCGATCCTTCCCGAATG
CGACGGAACCATTTATTCA -> GACGGAACCATTTATTCAG
CGACGGAAGAACGCGGACT -> GACGGAAGAACGCGGACTT
CGACGGAAGTCTAGCCTAA -> GACGGAAGTCTAGCCTAAA
CGAGACGTAGTATTGATAC -> GAGACGTAGTATTGATACC
CGAGAGAGAGTGTGAGGTC -> GAGAGAGAGTGTGAGGTCA
CGAGCCATCTTTGGTGACG -> GAGCCATCTTTGGTGACGG
CGAGCCCAGAGATACTCCT -> GAGCCCAGAGATACTCCTA
CGAGGATCGTCTCAGGGTG -> GAGGATCGTCTCAGGGTGC
CGAGGGAAGGGCAATCAAT -> GAGGGAAGGGCAATCAATG
CGAGTGCGGGTAGATTTAA -> GAGTGCGGGTAGATTTAAT
CGATACGGGGAACCCACCA -> GATACGGGGAACCCACCAC
CGATACTATAGCGGCGATA -> GATACTATAGCGGCGATAC
CGATACTTATTCCGTGGGC -> GATACTTATTCCGTGGGCG
CGATAGCAATGGTTTCCGC -> GATAGCAATGGTTTCCGCC
CGATAGCGGATCGTCTTTC -> GATAGCGGATCGTCTTTCA
CGATCACATGTGCTATTAA -> GATCACATGTGCTATTAAG
CGATCCGCCAATGCCCCTC -> GATCCGCCAATGCCCCTCG
CGATCCTTCCCGAATGGGC -> GATCCTTCCCGAATGGGCC
CGATCGTCAGCAGGGCAGT -> GATCGTCAGCAGGGCAGTT
CGATGCCAAGAATGCATTC -> GATGCCAAGAATGCATTCC
CGATGGACGACCGATCCTT -> GATGGACGACCGATCCTTC
CGATTCATCTACGCACCTC -> GATTCATCTACGCACCTCT
CGATTTGTCGCCCTTTGTA -> GATTTGTCGCCCTTTGTAC
CGCAATGTACCGCTCCTGC -> GCAATGTACCGCTCCTGCA
CGCACCTCTTAAGACGGCA -> GCACCTCTTAAGACGGCAA
CGCCAAAGGTAGGGCCGGG -> GCCAAAGGTAGGGCCGGGC
CGCCAATGCCCCTCGCTGC -> GCCAATGCCCCTCGCTGCG
CGCCACTCTATGACTGATA -> GCCACTCTATGACTGATAG
CGCCAGCCTGAAGACGTGC -> GCCAGCCTGAAGACGTGCC
CGCCAGGGGCCAGCGGAAG -> GCCAGGGGCCAGCGGAAGC
CGCCATGGTAGCCAAGATA -> GCCATGGTAGCCAAGATAT
CGCCCAATTCACCCGGCGC -> GCCCAATTCACCCGGCGCC
CGCCCCAGTCCACAATCTC -> GCCCCAGTCCACAATCTCG
CGCCCCGACGGAACCATTT -> GCCCCGACGGAACCATTTA
CGCCCTTTGTACCCTGACG -> GCCCTTTGTACCCTGACGG
CGCCGTAGTCATACTACTG -> GCCGTAGTCATACTACTGC
CGCCTCTGGCCGACCCTTG -> GCCTCTGGCCGACCCTTGA
CGCCTTCGGTTCTGCCAAT -> GCCTTCGGTTCTGCCAATG
CGCGGACAAATGGTGCTAC -> GCGGACAAATGGTGCTACT
CGCGGACTTCGCCACTCTA -> GCGGACTTCGCCACTCTAT
CGCGGCAGCCAAGGGACAT -> GCGGCAGCCAAGGGACATC
CGCGGGCTTACGACACCGA -> GCGGGCTTACGACACCGAA
CGCGTACCCCGATGCCAAG -> GCGTACCCCGATGCCAAGA
CGCGTACTATGGTACTGAC -> GCGTACTATGGTACTGACG
CGCTAGCTCAACGCTATGC -> GCTAGCTCAACGCTATGCC
CGCTATGCCGGAAAGACAT -> GCTATGCCGGAAAGACATC
CGCTCCGATCCGCCAATGC -> GCTCCGATCCGCCAATGCC
CGCTCCTGCAAAAGATAAT -> GCTCCTGCAAAAGATAATC
CGCTGCGTCGAAATTCACT -> GCTGCGTCGAAATTCACTC
CGCTTGCAAGGCGGTAGGG -> GCTTGCAAGGCGGTAGGGA
CGGAAAGACATCTTGGCGA -> GGAAAGACATCTTGGCGAC
CGGAACCATTTATTCAGGG -> GGAACCATTTATTCAGGGC
CGGAAGAACGCGGACTTCG -> GGAAGAACGCGGACTTCGC
CGGAAGCTAACAACAAGTA -> GGAAGCTAACAACAAGTAC
CGGAAGTCTAGCCTAAATT -> GGAAGTCTAGCCTAAATTC
CGGACAAATGGTGCTACTT -> GGACAAATGGTGCTACTTG
CGGACACTCGCGGCAGCCA -> GGACACTCGCGGCAGCCAA
CGGACTTCGCCACTCTATG -> GGACTTCGCCACTCTATGA
CGGAGGGATGGAGCCACGT -> GGAGGGATGGAGCCACGTC
CGGATCGTCTTTCAAACTG -> GGATCGTCTTTCAAACTGA
CGGCAATTGCATAGTTGCC -> GGCAATTGCATAGTTGCCG
CGGCAGCCAAGGGACATCT -> GGCAGCCAAGGGACATCTC
CGGCCACCTCACTATTGGT -> GGCCACCTCACTATTGGTA
CGGCCTACCAGGAAGCTAA -> GGCCTACCAGGAAGCTAAC
CGGCCTGGCCCGGGTTCCA -> GGCCTGGCCCGGGTTCCAC
CGGCGATACTTATTCCGTG -> GGCGATACTTATTCCGTGG
CGGCGCCTCTGGCCGACCC -> GGCGCCTCTGGCCGACCCT
CGGCTATGAAGACCCGCCG -> GGCTATGAAGACCCGCCGT
CGGCTCATTACCAGGACGG -> GGCTCATTACCAGGACGGG
CGGGATGTGGGTATACATC -> GGGATGTGGGTATACATCT
CGGGCACGTAAGCTTGATG -> GGGCACGTAAGCTTGATGT
CGGGCATTCTGCTTTGGAA -> GGGCATTCTGCTTTGGAAG
CGGGCTTACGACACCGAAC -> GGGCTTACGACACCGAACT
CGGGGAACCCACCACTCGT -> GGGGAACCCACCACTCGTC
CGGGGGGCCAGAGGGGGTT -> GGGGGGCCAGAGGGGGTTT
CGGGTACCGACAATTTAGC -> GGGTACCGACAATTTAGCA
CGGGTAGATTTAATCTCCC -> GGGTAGATTTAATCTCCCA, GGGTAGATTTAATCTCCCA, GGGTAGATTTAATCTCCCC
CGGGTAGATTTAATCTCCT -> GGGTAGATTTAATCTCCTC
CGGGTAGCCCGGGATGTGG -> GGGTAGCCCGGGATGTGGG
CGGGTTCCACGGCTCATTA -> GGGTTCCACGGCTCATTAC
CGGGTTCGTTTATGAAATC -> GGGTTCGTTTATGAAATCT
CGGTACTATCCCCTGGCAT -> GGTACTATCCCCTGGCATA
CGGTAGGGAAGCTAACAAC -> GGTAGGGAAGCTAACAACA
CGGTAGGGTTCAACAAGCA -> GGTAGGGTTCAACAAGCAG
CGGTCGTCCGCCCCGACGG -> GGTCGTCCGCCCCGACGGA
CGGTGAGCATTTTGAGTTT -> GGTGAGCATTTTGAGTTTT
CGGTTACAAAAGGCCACGA -> GGTTACAAAAGGCCACGAT
CGGTTCTGCCAATGCCTTT -> GGTTCTGCCAATGCCTTTA
CGGTTTTGCGGGTAGATTT -> GGTTTTGCGGGTAGATTTA
CGTAAGCTTGATGTTGCTT -> GTAAGCTTGATGTTGCTTG
CGTACCCCGATGCCAAGAA -> GTACCCCGATGCCAAGAAT
CGTACTAGCTTAATCAGAT -> GTACTAGCTTAATCAGATG
CGTACTATGGTACTGACGA -> GTACTATGGTACTGACGAC
CGTAGCGTGATTATGGACA -> GTAGCGTGATTATGGACAA
CGTAGGCGAGGGAAGGGCA -> GTAGGCGAGGGAAGGGCAA
CGTAGTATTGATACCCAAT -> GTAGTATTGATACCCAATT
CGTAGTCATACTACTGCAT -> GTAGTCATACTACTGCATT
CGTATTCTGCATCAGTGTG -> GTATTCTGCATCAGTGTGC
CGTCACGATTTGTCGCCCT -> GTCACGATTTGTCGCCCTT
CGTCAGCAGGGCAGTTGGA -> GTCAGCAGGGCAGTTGGAT
CGTCCAGACAAGGAAGGTA -> GTCCAGACAAGGAAGGTAG
CGTCCCACGCGTACCCCGA -> GTCCCACGCGTACCCCGAT
CGTCCGCCCCGACGGAACC -> GTCCGCCCCGACGGAACCA
CGTCGAAATTCACTCGAGG -> GTCGAAATTCACTCGAGGA
CGTCTCAGGGTGCCTGACT -> GTCTCAGGGTGCCTGACTT
CGTCTTACGGCCACCTCAC -> GTCTTACGGCCACCTCACT
CGTCTTTCAAACTGAATCA -> GTCTTTCAAACTGAATCAG
CGTGATTATGGACAAGAAA -> GTGATTATGGACAAGAAAG
CGTGCCACTATGAGCTTCG -> GTGCCACTATGAGCTTCGC
CGTGCCGAATGTTCGCCAG -> GTGCCGAATGTTCGCCAGC
CGTGCTACCTCTTGCTTGT -> GTGCTACCTCTTGCTTGTT
CGTGGAAAAGCTCCATATC -> GTGGAAAAGCTCCATATCA
CGTGGGCGCCAAAGGTAGG -> GTGGGCGCCAAAGGTAGGG
CGTGTTGGTCAAAAACCAC -> GTGTTGGTCAAAAACCACT
CGTTACAAAAAGCACTACC -> GTTACAAAAAGCACTACCA
CGTTCGAAGTCTAGGTCAC -> GTTCGAAGTCTAGGTCACC
CGTTGATGAGTGGCGTGCT -> GTTGATGAGTGGCGTGCTA
CGTTTATGAAATCTGGTTA -> GTTTATGAAATCTGGTTAA
CGTTTCCCCTTGAATGAAG -> GTTTCCCCTTGAATGAAGT
CTAAATTCGTCCAGACAAG -> TAAATTCGTCCAGACAAGG
CTAACAACAAGTAATTTAG -> TAACAACAAGTAATTTAGC
CTAACAACAAGTACCCAAA -> TAACAACAAGTACCCAAAA
CTAACAACAAGTAGAAGCG -> TAACAACAAGTAGAAGCGG
CTAACAACAAGTATACCTG -> TAACAACAAGTATACCTGG
CTAATGCCGATCGTCAGCA -> TAATGCCGATCGTCAGCAG
CTACAAAGGTAAATTAGAG -> TACAAAGGTAAATTAGAGT
CTACATATTGCCGTTCGAA -> TACATATTGCCGTTCGAAG
CTACCACCCAATAATAAAG -> TACCACCCAATAATAAAGC
CTACCAGGAAGCTAACAAC -> TACCAGGAAGCTAACAACA
CTACCAGGCCTCCCTCTTA -> TACCAGGCCTCCCTCTTAG
CTACCTCTTGCTTGTTAAA -> TACCTCTTGCTTGTTAAAT
CTACCTGGAAAAGAGCCTG -> TACCTGGAAAAGAGCCTGA
CTACGATACTATAGCGGCG -> TACGATACTATAGCGGCGA
CTACGCACCTCTTAAGACG -> TACGCACCTCTTAAGACGG
CTACTGCATTACCCTCTGG -> TACTGCATTACCCTCTGGG
CTACTTGGTATGACGCTTG -> TACTTGGTATGACGCTTGC
CTAGACAAATACCGACATT -> TAGACAAATACCGACATTT
CTAGCCTAAATTCGTCCAG -> TAGCCTAAATTCGTCCAGA
CTAGCCTACAAAGGTAAAT -> TAGCCTACAAAGGTAAATT
CTAGCGTCCCACGCGTACC -> TAGCGTCCCACGCGTACCC
CTAGCTCAACGCTATGCCG -> TAGCTCAACGCTATGCCGG
CTAGCTTAATCAGATGCAG -> TAGCTTAATCAGATGCAGT
CTAGGTCACCATACCAGTT -> TAGGTCACCATACCAGTTC
CTAGGTCGGTGAGCATTTT -> TAGGTCGGTGAGCATTTTG
CTATAGCGGCGATACTTAT -> TATAGCGGCGATACTTATT
CTATCCCCTGGCATAATCG -> TATCCCCTGGCATAATCGA
CTATGAAGACCCGCCGTAG -> TATGAAGACCCGCCGTAGT
CTATGACTGATAGAATTCT -> TATGACTGATAGAATTCTG
CTATGAGCTTCGCTAGCTC -> TATGAGCTTCGCTAGCTCA
CTATGCCGGAAAGACATCT -> TATGCCGGAAAGACATCTT
CTATGCGGGTAGATTTAAT -> TATGCGGGTAGATTTAATC
CTATGGTACTGACGACCAC -> TATGGTACTGACGACCACC
CTATTAAGGTACTCATATT -> TATTAAGGTACTCATATTC
CTATTCATCGCCAGGGGCC -> TATTCATCGCCAGGGGCCA
CTATTGAGTCGAGACGTAG -> TATTGAGTCGAGACGTAGT
CTATTGGTAATATCGGGGG -> TATTGGTAATATCGGGGGG
CTCAACGCTATGCCGGAAA -> TCAACGCTATGCCGGAAAG
CTCACTAGCGTCCCACGCG -> TCACTAGCGTCCCACGCGT
CTCACTATTGGTAATATCG -> TCACTATTGGTAATATCGG
CTCAGGGTGCCTGACTTGT -> TCAGGGTGCCTGACTTGTA
CTCATATTCACAGCCCGTA -> TCATATTCACAGCCCGTAG
CTCATTACCAGGACGGGTA -> TCATTACCAGGACGGGTAG
CTCCAGCGCGTACTATGGT -> TCCAGCGCGTACTATGGTA
CTCCAGTTCGATGGACGAC -> TCCAGTTCGATGGACGACC
CTCCATATCACTCACTAGC -> TCCATATCACTCACTAGCG
CTCCCACCCGCTCCGATCC -> TCCCACCCGCTCCGATCCG
CTCCCACGAGCCCAGAGAT -> TCCCACGAGCCCAGAGATA
CTCCCAGTTTTCGGAGGGA -> TCCCAGTTTTCGGAGGGAT
CTCCCCGATTCATCTACGC -> TCCCCGATTCATCTACGCA
CTCCCGCAATGTACCGCTC -> TCCCGCAATGTACCGCTCC
CTCCCTCTTAGCACGTACT -> TCCCTCTTAGCACGTACTA
CTCCGACGGAAGAACGCGG -> TCCGACGGAAGAACGCGGA
CTCCGATCCGCCAATGCCC -> TCCGATCCGCCAATGCCCC
CTCCGGGCATTCTGCTTTG -> TCCGGGCATTCTGCTTTGG
CTCCGTGCCGAATGTTCGC -> TCCGTGCCGAATGTTCGCC
CTCCTATTCATCGCCAGGG -> TCCTATTCATCGCCAGGGG
CTCCTCCGACGGAAGAACG -> TCCTCCGACGGAAGAACGC
CTCCTGCAAAAGATAATCT -> TCCTGCAAAAGATAATCTC
CTCGAGGATCGTCTCAGGG -> TCGAGGATCGTCTCAGGGT
CTCGCCATGGTAGCCAAGA -> TCGCCATGGTAGCCAAGAT
CTCGCGGCAGCCAAGGGAC -> TCGCGGCAGCCAAGGGACA
CTCGCTGCGTCGAAATTCA -> TCGCTGCGTCGAAATTCAC
CTCGTATTCTGCATCAGTG -> TCGTATTCTGCATCAGTGT
CTCGTCACGATTTGTCGCC -> TCGTCACGATTTGTCGCCC
CTCGTTGATGAGTGGCGTG -> TCGTTGATGAGTGGCGTGC
CTCTACCAGGCCTCCCTCT -> TCTACCAGGCCTCCCTCTT
CTCTAGGTCGGTGAGCATT -> TCTAGGTCGGTGAGCATTT
CTCTATGACTGATAGAATT -> TCTATGACTGATAGAATTC
CTCTATTGAGTCGAGACGT -> TCTATTGAGTCGAGACGTA
CTCTCCCAGTTTTCGGAGG -> TCTCCCAGTTTTCGGAGGG
CTCTGAGTAGAGCGTGTTG -> TCTGAGTAGAGCGTGTTGG
CTCTGGCCGACCCTTGAAA -> TCTGGCCGACCCTTGAAAC
CTCTGGGGCACCAATCTGC -> TCTGGGGCACCAATCTGCA
CTCTTAAGACGGCAATTGC -> TCTTAAGACGGCAATTGCA
CTCTTAGCACGTACTAGCT -> TCTTAGCACGTACTAGCTT
CTCTTGCTTGTTAAATGGG -> TCTTGCTTGTTAAATGGGC
CTGAACGGTACTATCCCCT -> TGAACGGTACTATCCCCTG
CTGAAGACGTGCCACTATG -> TGAAGACGTGCCACTATGA
CTGAATCAGGCATAGGGCT -> TGAATCAGGCATAGGGCTG
CTGAATTAGGAACAGTGAT -> TGAATTAGGAACAGTGATG
CTGACGACCACCTGGGAGT -> TGACGACCACCTGGGAGTA
CTGACGGCCTGGCCCGGGT -> TGACGGCCTGGCCCGGGTT
CTGACTTGTAATTCAAGCC -> TGACTTGTAATTCAAGCCT
CTGAGTAGAGCGTGTTGGT -> TGAGTAGAGCGTGTTGGTC
CTGATAGAATTCTGTAAGT -> TGATAGAATTCTGTAAGTA
CTGATAGCCCTAATGCCGA -> TGATAGCCCTAATGCCGAT
CTGATGCGGTAGGGTTCAA -> TGATGCGGTAGGGTTCAAC
CTGCAAAAGATAATCTCTA -> TGCAAAAGATAATCTCTAC
CTGCATCAGTGTGCCCCAG -> TGCATCAGTGTGCCCCAGT
CTGCATCTACATATTGCCG -> TGCATCTACATATTGCCGT
CTGCATTACCCTCTGGGGC -> TGCATTACCCTCTGGGGCA
CTGCATTTCGGGTTCGTTT -> TGCATTTCGGGTTCGTTTA
CTGCCAATGCCTTTAGAAA -> TGCCAATGCCTTTAGAAAC
CTGCGTCGAAATTCACTCG -> TGCGTCGAAATTCACTCGA
CTGCTTTGGAAGCTAACAA -> TGCTTTGGAAGCTAACAAC
CTGGAAAAGAGCCTGAATT -> TGGAAAAGAGCCTGAATTA
CTGGCATAATCGATAGCGG -> TGGCATAATCGATAGCGGA
CTGGCCCGGGTTCCACGGC -> TGGCCCGGGTTCCACGGCT
CTGGCCGACCCTTGAAACA -> TGGCCGACCCTTGAAACAT
CTGGCTATGCGGGTAGATT -> TGGCTATGCGGGTAGATTT
CTGGGAGTATAGATCATCG -> TGGGAGTATAGATCATCGG
CTGGGGCACCAATCTGCAT -> TGGGGCACCAATCTGCATC
CTGGTTAATTGACCCCGAT -> TGGTTAATTGACCCCGATC
CTGTAAGTAAACGTTACAA -> TGTAAGTAAACGTTACAAA
CTGTCTACGATACTATAGC -> TGTCTACGATACTATAGCG
CTTAAGACGGCAATTGCAT -> TTAAGACGGCAATTGCATA
CTTAATCAGATGCAGTATA -> TTAATCAGATGCAGTATAC
CTTACGACACCGAACTCCC -> TTACGACACCGAACTCCCG
CTTACGGCCACCTCACTAT -> TTACGGCCACCTCACTATT
CTTAGCACGTACTAGCTTA -> TTAGCACGTACTAGCTTAA
CTTAGGCGACGGAAGTCTA -> TTAGGCGACGGAAGTCTAG
CTTATTCCGTGGGCGCCAA -> TTATTCCGTGGGCGCCAAA
CTTCCCGAATGGGCCAAAT -> TTCCCGAATGGGCCAAATT
CTTCGAGCCATCTTTGGTG -> TTCGAGCCATCTTTGGTGA
CTTCGCCACTCTATGACTG -> TTCGCCACTCTATGACTGA
CTTCGCTAGCTCAACGCTA -> TTCGCTAGCTCAACGCTAT
CTTCGGTTCTGCCAATGCC -> TTCGGTTCTGCCAATGCCT
CTTGAAACATGCTTTCCCG -> TTGAAACATGCTTTCCCGA
CTTGAATGAAGTTTAAGTT -> TTGAATGAAGTTTAAGTTG
CTTGATGTTGCTTGTTTCT -> TTGATGTTGCTTGTTTCTC
CTTGCAAGGCGGTAGGGAA -> TTGCAAGGCGGTAGGGAAG
CTTGCGGGTAGATTTAATC -> TTGCGGGTAGATTTAATCT
CTTGCTTGTTAAATGGGCT -> TTGCTTGTTAAATGGGCTA
CTTGGCGACCACTCCAGTT -> TTGGCGACCACTCCAGTTC
CTTGGTATGACGCTTGCAA -> TTGGTATGACGCTTGCAAG
CTTGTAATTCAAGCCTCTC -> TTGTAATTCAAGCCTCTCC
CTTGTTAAATGGGCTAGAC -> TTGTTAAATGGGCTAGACA
CTTGTTTCTCGCCATGGTA -> TTGTTTCTCGCCATGGTAG
CTTTAGAAACCGGCCTACC -> TTTAGAAACCGGCCTACCA
CTTTCAAACTGAATCAGGC -> TTTCAAACTGAATCAGGCA
CTTTCCCGAGAGAGAGTGT -> TTTCCCGAGAGAGAGTGTG
CTTTGGAAGCTAACAACAA -> TTTGGAAGCTAACAACAAG
CTTTGGTGACGGTTACAAA -> TTTGGTGACGGTTACAAAA
CTTTGTACCCTGACGGCCT -> TTTGTACCCTGACGGCCTG
GAAAAGAGCCTGAATTAGG -> AAAAGAGCCTGAATTAGGA
GAAAAGCTCCATATCACTC -> AAAAGCTCCATATCACTCA
GAAACATGCTTTCCCGAGA -> AAACATGCTTTCCCGAGAG
GAAACCGGCCTACCAGGAA -> AAACCGGCCTACCAGGAAG
GAAAGAAGCGGACACTCGC -> AAAGAAGCGGACACTCGCG
GAAAGACATCTTGGCGACC -> AAAGACATCTTGGCGACCA
GAAATCTGGTTAATTGACC -> AAATCTGGTTAATTGACCC
GAAATTCACTCGAGGATCG -> AAATTCACTCGAGGATCGT
GAACACGCCCCAGTCCACA -> AACACGCCCCAGTCCACAA
GAACAGTGATGGATGCGGG -> AACAGTGATGGATGCGGGT
GAACCATTTATTCAGGGCC -> AACCATTTATTCAGGGCCT
GAACCCACCACTCGTCACG -> AACCCACCACTCGTCACGA
GAACGCGGACTTCGCCACT -> AACGCGGACTTCGCCACTC
GAACGGTACTATCCCCTGG -> AACGGTACTATCCCCTGGC
GAACGTGGAAAAGCTCCAT -> AACGTGGAAAAGCTCCATA
GAACTCCCGCAATGTACCG -> AACTCCCGCAATGTACCGC
GAAGAACGCGGACTTCGCC -> AAGAACGCGGACTTCGCCA
GAAGACCCGCCGTAGTCAT -> AAGACCCGCCGTAGTCATA
GAAGACGTGCCACTATGAG -> AAGACGTGCCACTATGAGC
GAAGACTAGCCTACAAAGG -> AAGACTAGCCTACAAAGGT
GAAGCGGACACTCGCGGCA -> AAGCGGACACTCGCGGCAG
GAAGCGGTTTTGCGGGTAG -> AAGCGGTTTTGCGGGTAGA
GAAGCTAACAACAAGTAAT -> AAGCTAACAACAAGTAATT
GAAGCTAACAACAAGTACC -> AAGCTAACAACAAGTACCC
GAAGCTAACAACAAGTAGA -> AAGCTAACAACAAGTAGAA
GAAGCTAACAACAAGTATA -> AAGCTAACAACAAGTATAC
GAAGGGCAATCAATGGCCT -> AAGGGCAATCAATGGCCTC
GAAGGTAGTCCCTCGTTGA -> AAGGTAGTCCCTCGTTGAT
GAAGTCTAGCCTAAATTCG -> AAGTCTAGCCTAAATTCGT
GAAGTCTAGGTCACCATAC -> AAGTCTAGGTCACCATACC
GAAGTTTAAGTTGGACGAT -> AAGTTTAAGTTGGACGATA
GAATCAGGCATAGGGCTGA -> AATCAGGCATAGGGCTGAT
GAATGAAGTTTAAGTTGGA -> AATGAAGTTTAAGTTGGAC
GAATGCATTCCGCGGGCTT -> AATGCATTCCGCGGGCTTA
GAATGGGCCAAATTTCTGA -> AATGGGCCAAATTTCTGAA
GAATGTTCGCCAGCCTGAA -> AATGTTCGCCAGCCTGAAG
GAATTAGGAACAGTGATGG -> AATTAGGAACAGTGATGGA
GAATTCTGTAAGTAAACGT -> AATTCTGTAAGTAAACGTT
GACAAATACCGACATTTAG -> ACAAATACCGACATTTAGT
GACAAATGGTGCTACTTGG -> ACAAATGGTGCTACTTGGT
GACAAGAAAGAAGCGGACA -> ACAAGAAAGAAGCGGACAC
GACAAGGAAGGTAGTCCCT -> ACAAGGAAGGTAGTCCCTC
GACAATTTAGCAAGATTTA -> ACAATTTAGCAAGATTTAT
GACACCGAACTCCCGCAAT -> ACACCGAACTCCCGCAATG
GACACTCGCGGCAGCCAAG -> ACACTCGCGGCAGCCAAGG
GACATCTCCAGCGCGTACT -> ACATCTCCAGCGCGTACTA
GACATCTTGGCGACCACTC -> ACATCTTGGCGACCACTCC
GACATTTAGTTGTCGCCCA -> ACATTTAGTTGTCGCCCAA
GACCACCTGGGAGTATAGA -> ACCACCTGGGAGTATAGAT
GACCACTCCAGTTCGATGG -> ACCACTCCAGTTCGATGGA
GACCCCGATCACATGTGCT -> ACCCCGATCACATGTGCTA
GACCCGCCGTAGTCATACT -> ACCCGCCGTAGTCATACTA
GACCCTTGAAACATGCTTT -> ACCCTTGAAACATGCTTTC
GACCGATCCTTCCCGAATG -> ACCGATCCTTCCCGAATGG
GACGACCACCTGGGAGTAT -> ACGACCACCTGGGAGTATA
GACGACCGATCCTTCCCGA -> ACGACCGATCCTTCCCGAA
GACGATAGCAATGGTTTCC -> ACGATAGCAATGGTTTCCG
GACGCTTGCAAGGCGGTAG -> ACGCTTGCAAGGCGGTAGG
GACGGAACCATTTATTCAG -> ACGGAACCATTTATTCAGG
GACGGAAGAACGCGGACTT -> ACGGAAGAACGCGGACTTC
GACGGAAGTCTAGCCTAAA -> ACGGAAGTCTAGCCTAAAT
GACGGCAATTGCATAGTTG -> ACGGCAATTGCATAGTTGC
GACGGCCTGGCCCGGGTTC -> ACGGCCTGGCCCGGGTTCC
GACGGGTAGCCCGGGATGT -> ACGGGTAGCCCGGGATGTG
GACGGTTACAAAAGGCCAC -> ACGGTTACAAAAGGCCACG
GACGTAGTATTGATACCCA -> ACGTAGTATTGATACCCAA
GACGTGCCACTATGAGCTT -> ACGTGCCACTATGAGCTTC
GACTAGCCTACAAAGGTAA -> ACTAGCCTACAAAGGTAAA
GACTCCGGGCATTCTGCTT -> ACTCCGGGCATTCTGCTTT
GACTGATAGAATTCTGTAA -> ACTGATAGAATTCTGTAAG
GACTTCGCCACTCTATGAC -> ACTTCGCCACTCTATGACT
GACTTGTAATTCAAGCCTC -> ACTTGTAATTCAAGCCTCT
GAGACGTAGTATTGATACC -> AGACGTAGTATTGATACCC
GAGAGAGAGTGTGAGGTCA -> AGAGAGAGTGTGAGGTCAA
GAGAGAGTGTGAGGTCAAC -> AGAGAGTGTGAGGTCAACT
GAGAGTGTGAGGTCAACTA -> AGAGTGTGAGGTCAACTAC
GAGATACTCCTATTCATCG -> AGATACTCCTATTCATCGC
GAGCATTTTGAGTTTTGAA -> AGCATTTTGAGTTTTGAAG
GAGCCACGTCTTACGGCCA -> AGCCACGTCTTACGGCCAC
GAGCCATCTTTGGTGACGG -> AGCCATCTTTGGTGACGGT
GAGCCCAGAGATACTCCTA -> AGCCCAGAGATACTCCTAT
GAGCCTGAATTAGGAACAG -> AGCCTGAATTAGGAACAGT
GAGCGTGTTGGTCAAAAAC -> AGCGTGTTGGTCAAAAACC
GAGCTCTGAGTAGAGCGTG -> AGCTCTGAGTAGAGCGTGT
GAGCTTCGCTAGCTCAACG -> AGCTTCGCTAGCTCAACGC
GAGGATCGTCTCAGGGTGC -> AGGATCGTCTCAGGGTGCC
GAGGGAAGGGCAATCAATG -> AGGGAAGGGCAATCAATGG
GAGGGATGGAGCCACGTCT -> AGGGATGGAGCCACGTCTT
GAGGGCGGTCGTCCGCCCC -> AGGGCGGTCGTCCGCCCCG
GAGGGGGTTTAATTGAGCT -> AGGGGGTTTAATTGAGCTC
GAGGTCAACTACCTGGAAA -> AGGTCAACTACCTGGAAAA
GAGTAGAGCGTGTTGGTCA -> AGTAGAGCGTGTTGGTCAA
GAGTATAGATCATCGGCTA -> AGTATAGATCATCGGCTAT
GAGTCGAGACGTAGTATTG -> AGTCGAGACGTAGTATTGA
GAGTGCGGGTAGATTTAAT -> AGTGCGGGTAGATTTAATC
GAGTGGCGTGCTACCTCTT -> AGTGGCGTGCTACCTCTTG
GAGTGTGAGGTCAACTACC -> AGTGTGAGGTCAACTACCT
GAGTTTTGAAGACTAGCCT -> AGTTTTGAAGACTAGCCTA
GATAAGGACTCCGGGCATT -> ATAAGGACTCCGGGCATTC
GATAATCTCTACCAGGCCT -> ATAATCTCTACCAGGCCTC
GATACCCAATTTGTTAGCT -> ATACCCAATTTGTTAGCTG
GATACGGGGAACCCACCAC -> ATACGGGGAACCCACCACT
GATACTATAGCGGCGATAC -> ATACTATAGCGGCGATACT
GATACTCCTATTCATCGCC -> ATACTCCTATTCATCGCCA
GATACTTATTCCGTGGGCG -> ATACTTATTCCGTGGGCGC
GATAGAATTCTGTAAGTAA -> ATAGAATTCTGTAAGTAAA
GATAGCAATGGTTTCCGCC -> ATAGCAATGGTTTCCGCCT
GATAGCCCTAATGCCGATC -> ATAGCCCTAATGCCGATCG
GATAGCGGATCGTCTTTCA -> ATAGCGGATCGTCTTTCAA
GATATAAGTGATAAGGACT -> ATATAAGTGATAAGGACTC
GATCACATGTGCTATTAAG -> ATCACATGTGCTATTAAGG
GATCATCGGCTATGAAGAC -> ATCATCGGCTATGAAGACC
GATCCGCCAATGCCCCTCG -> ATCCGCCAATGCCCCTCGC
GATCCTTCCCGAATGGGCC -> ATCCTTCCCGAATGGGCCA
GATCGTCAGCAGGGCAGTT -> ATCGTCAGCAGGGCAGTTG
GATCGTCTCAGGGTGCCTG -> ATCGTCTCAGGGTGCCTGA
GATCGTCTTTCAAACTGAA -> ATCGTCTTTCAAACTGAAT
GATGAGTGGCGTGCTACCT -> ATGAGTGGCGTGCTACCTC
GATGCAGTATACGTAGGCG -> ATGCAGTATACGTAGGCGA
GATGCCAAGAATGCATTCC -> ATGCCAAGAATGCATTCCG
GATGCGGGTACCGACAATT -> ATGCGGGTACCGACAATTT
GATGCGGTAGGGTTCAACA -> ATGCGGTAGGGTTCAACAA
GATGGAACGTGGAAAAGCT -> ATGGAACGTGGAAAAGCTC
GATGGACGACCGATCCTTC -> ATGGACGACCGATCCTTCC
GATGGAGCCACGTCTTACG -> ATGGAGCCACGTCTTACGG
GATGGATGCGGGTACCGAC -> ATGGATGCGGGTACCGACA
GATGTGGGTATACATCTTA -> ATGTGGGTATACATCTTAG
GATGTTGCTTGTTTCTCGC -> ATGTTGCTTGTTTCTCGCC
GATTATGGACAAGAAAGAA -> ATTATGGACAAGAAAGAAG
GATTCATCTACGCACCTCT -> ATTCATCTACGCACCTCTT
GATTTAATCTCCCACCCGC -> ATTTAATCTCCCACCCGCT
GATTTAATCTCCCACGAGC -> ATTTAATCTCCCACGAGCC
GATTTAATCTCCCCGATTC -> ATTTAATCTCCCCGATTCA
GATTTAATCTCCTCCGACG -> ATTTAATCTCCTCCGACGG
GATTTATGAACACGCCCCA -> ATTTATGAACACGCCCCAG
GATTTGTCGCCCTTTGTAC -> ATTTGTCGCCCTTTGTACC
GCAAAAGATAATCTCTACC -> CAAAAGATAATCTCTACCA
GCAAGATTTATGAACACGC -> CAAGATTTATGAACACGCC
GCAAGGCGGTAGGGAAGCT -> CAAGGCGGTAGGGAAGCTA
GCAATCAATGGCCTCTAGG -> CAATCAATGGCCTCTAGGT
GCAATGGTTTCCGCCTTCG -> CAATGGTTTCCGCCTTCGG
GCAATGTACCGCTCCTGCA -> CAATGTACCGCTCCTGCAA
GCAATTGCATAGTTGCCGC -> CAATTGCATAGTTGCCGCG
GCACCAATCTGCATCTACA -> CACCAATCTGCATCTACAT
GCACCTCTTAAGACGGCAA -> CACCTCTTAAGACGGCAAT
GCACGTAAGCTTGATGTTG -> CACGTAAGCTTGATGTTGC
GCACGTACTAGCTTAATCA -> CACGTACTAGCTTAATCAG
GCACTACCACCCAATAATA -> CACTACCACCCAATAATAA
GCAGCCAAGGGACATCTCC -> CAGCCAAGGGACATCTCCA
GCAGGGCAGTTGGATGGAA -> CAGGGCAGTTGGATGGAAC
GCAGGTCCCCACTTCGAGC -> CAGGTCCCCACTTCGAGCC
GCAGTATACGTAGGCGAGG -> CAGTATACGTAGGCGAGGG
GCAGTTGGATGGAACGTGG -> CAGTTGGATGGAACGTGGA
GCATAATCGATAGCGGATC -> CATAATCGATAGCGGATCG
GCATAGGGCTGATGCGGTA -> CATAGGGCTGATGCGGTAG
GCATAGTTGCCGCGGACAA -> CATAGTTGCCGCGGACAAA
GCATCAGTGTGCCCCAGTA -> CATCAGTGTGCCCCAGTAC
GCATCTACATATTGCCGTT -> CATCTACATATTGCCGTTC
GCATTACCCTCTGGGGCAC -> CATTACCCTCTGGGGCACC
GCATTCCGCGGGCTTACGA -> CATTCCGCGGGCTTACGAC
GCATTCTGCTTTGGAAGCT -> CATTCTGCTTTGGAAGCTA
GCATTTCGGGTTCGTTTAT -> CATTTCGGGTTCGTTTATG
GCATTTTGAGTTTTGAAGA -> CATTTTGAGTTTTGAAGAC
GCCAAAGGTAGGGCCGGGC -> CCAAAGGTAGGGCCGGGCA
GCCAAATTTCTGAACGGTA -> CCAAATTTCTGAACGGTAC
GCCAAGAATGCATTCCGCG -> CCAAGAATGCATTCCGCGG
GCCAAGATATAAGTGATAA -> CCAAGATATAAGTGATAAG
GCCAAGGGACATCTCCAGC -> CCAAGGGACATCTCCAGCG
GCCAATGCCCCTCGCTGCG -> CCAATGCCCCTCGCTGCGT
GCCAATGCCTTTAGAAACC -> CCAATGCCTTTAGAAACCG
GCCACCTCACTATTGGTAA -> CCACCTCACTATTGGTAAT
GCCACGATACGGGGAACCC -> CCACGATACGGGGAACCCA
GCCACGTCTTACGGCCACC -> CCACGTCTTACGGCCACCT
GCCACTATGAGCTTCGCTA -> CCACTATGAGCTTCGCTAG
GCCACTCTATGACTGATAG -> CCACTCTATGACTGATAGA
GCCAGAGGGGGTTTAATTG -> CCAGAGGGGGTTTAATTGA
GCCAGCCTGAAGACGTGCC -> CCAGCCTGAAGACGTGCCA
GCCAGCGGAAGCTAACAAC -> CCAGCGGAAGCTAACAACA
GCCAGGGGCCAGCGGAAGC -> CCAGGGGCCAGCGGAAGCT
GCCATCTTTGGTGACGGTT -> CCATCTTTGGTGACGGTTA
GCCATGGTAGCCAAGATAT -> CCATGGTAGCCAAGATATA
GCCCAATTCACCCGGCGCC -> CCCAATTCACCCGGCGCCT
GCCCAGAGATACTCCTATT -> CCCAGAGATACTCCTATTC
GCCCCAGTACGTTTCCCCT -> CCCCAGTACGTTTCCCCTT
GCCCCAGTCCACAATCTCG -> CCCCAGTCCACAATCTCGT
GCCCCGACGGAACCATTTA -> CCCCGACGGAACCATTTAT
GCCCCTCGCTGCGTCGAAA -> CCCCTCGCTGCGTCGAAAT
GCCCGGGATGTGGGTATAC -> CCCGGGATGTGGGTATACA
GCCCGGGTTCCACGGCTCA -> CCCGGGTTCCACGGCTCAT
GCCCGTAGCGTGATTATGG -> CCCGTAGCGTGATTATGGA
GCCCTAATGCCGATCGTCA -> CCCTAATGCCGATCGTCAG
GCCCTTTGTACCCTGACGG -> CCCTTTGTACCCTGACGGC
GCCGAATGTTCGCCAGCCT -> CCGAATGTTCGCCAGCCTG
GCCGACCCTTGAAACATGC -> CCGACCCTTGAAACATGCT
GCCGATCGTCAGCAGGGCA -> CCGATCGTCAGCAGGGCAG
GCCGCGGACAAATGGTGCT -> CCGCGGACAAATGGTGCTA
GCCGGAAAGACATCTTGGC -> CCGGAAAGACATCTTGGCG
GCCGGGCACGTAAGCTTGA -> CCGGGCACGTAAGCTTGAT
GCCGTAGTCATACTACTGC -> CCGTAGTCATACTACTGCA
GCCGTTCGAAGTCTAGGTC -> CCGTTCGAAGTCTAGGTCA
GCCTAAATTCGTCCAGACA -> CCTAAATTCGTCCAGACAA
GCCTACAAAGGTAAATTAG -> CCTACAAAGGTAAATTAGA
GCCTACCAGGAAGCTAACA -> CCTACCAGGAAGCTAACAA
GCCTCCCTCTTAGCACGTA -> CCTCCCTCTTAGCACGTAC
GCCTCCGTGCCGAATGTTC -> CCTCCGTGCCGAATGTTCG
GCCTCTAGGTCGGTGAGCA -> CCTCTAGGTCGGTGAGCAT
GCCTCTCCCAGTTTTCGGA -> CCTCTCCCAGTTTTCGGAG
GCCTCTGGCCGACCCTTGA -> CCTCTGGCCGACCCTTGAA
GCCTGAAGACGTGCCACTA -> CCTGAAGACGTGCCACTAT
GCCTGAATTAGGAACAGTG -> CCTGAATTAGGAACAGTGA
GCCTGACTTGTAATTCAAG -> CCTGACTTGTAATTCAAGC
GCCTGGCCCGGGTTCCACG -> CCTGGCCCGGGTTCCACGG
GCCTTCGGTTCTGCCAATG -> CCTTCGGTTCTGCCAATGC
GCCTTTAGAAACCGGCCTA -> CCTTTAGAAACCGGCCTAC
GCGACCACTCCAGTTCGAT -> CGACCACTCCAGTTCGATG
GCGACGGAAGTCTAGCCTA -> CGACGGAAGTCTAGCCTAA
GCGAGGGAAGGGCAATCAA -> CGAGGGAAGGGCAATCAAT
GCGAGTGCGGGTAGATTTA -> CGAGTGCGGGTAGATTTAA
GCGATACTTATTCCGTGGG -> CGATACTTATTCCGTGGGC
GCGCCAAAGGTAGGGCCGG -> CGCCAAAGGTAGGGCCGGG
GCGCCTCTGGCCGACCCTT -> CGCCTCTGGCCGACCCTTG
GCGCGTACTATGGTACTGA -> CGCGTACTATGGTACTGAC
GCGGAAGCTAACAACAAGT -> CGGAAGCTAACAACAAGTA
GCGGACAAATGGTGCTACT -> CGGACAAATGGTGCTACTT
GCGGACACTCGCGGCAGCC -> CGGACACTCGCGGCAGCCA
GCGGACTTCGCCACTCTAT -> CGGACTTCGCCACTCTATG
GCGGATCGTCTTTCAAACT -> CGGATCGTCTTTCAAACTG
GCGGCAGCCAAGGGACATC -> CGGCAGCCAAGGGACATCT
GCGGCGATACTTATTCCGT -> CGGCGATACTTATTCCGTG
GCGGGCTTACGACACCGAA -> CGGGCTTACGACACCGAAC
GCGGGTACCGACAATTTAG -> CGGGTACCGACAATTTAGC
GCGGGTAGATTTAATCTCC -> CGGGTAGATTTAATCTCCC, CGGGTAGATTTAATCTCCC, CGGGTAGATTTAATCTCCC, CGGGTAGATTTAATCTCCT
GCGGTAGGGAAGCTAACAA -> CGGTAGGGAAGCTAACAAC
GCGGTAGGGTTCAACAAGC -> CGGTAGGGTTCAACAAGCA
GCGGTCGTCCGCCCCGACG -> CGGTCGTCCGCCCCGACGG
GCGGTTTTGCGGGTAGATT -> CGGTTTTGCGGGTAGATTT
GCGTACCCCGATGCCAAGA -> CGTACCCCGATGCCAAGAA
GCGTACTATGGTACTGACG -> CGTACTATGGTACTGACGA
GCGTCCCACGCGTACCCCG -> CGTCCCACGCGTACCCCGA
GCGTCGAAATTCACTCGAG -> CGTCGAAATTCACTCGAGG
GCGTGATTATGGACAAGAA -> CGTGATTATGGACAAGAAA
GCGTGCTACCTCTTGCTTG -> CGTGCTACCTCTTGCTTGT
GCGTGTTGGTCAAAAACCA -> CGTGTTGGTCAAAAACCAC
GCTAACAACAAGTAATTTA -> CTAACAACAAGTAATTTAG
GCTAACAACAAGTACCCAA -> CTAACAACAAGTACCCAAA
GCTAACAACAAGTAGAAGC -> CTAACAACAAGTAGAAGCG
GCTAACAACAAGTATACCT -> CTAACAACAAGTATACCTG
GCTACCTCTTGCTTGTTAA -> CTACCTCTTGCTTGTTAAA
GCTACTTGGTATGACGCTT -> CTACTTGGTATGACGCTTG
GCTAGACAAATACCGACAT -> CTAGACAAATACCGACATT
GCTAGCTCAACGCTATGCC -> CTAGCTCAACGCTATGCCG
GCTATGAAGACCCGCCGTA -> CTATGAAGACCCGCCGTAG
GCTATGCCGGAAAGACATC -> CTATGCCGGAAAGACATCT
GCTATGCGGGTAGATTTAA -> CTATGCGGGTAGATTTAAT
GCTATTAAGGTACTCATAT -> CTATTAAGGTACTCATATT
GCTCAACGCTATGCCGGAA -> CTCAACGCTATGCCGGAAA
GCTCATTACCAGGACGGGT -> CTCATTACCAGGACGGGTA
GCTCCATATCACTCACTAG -> CTCCATATCACTCACTAGC
GCTCCGATCCGCCAATGCC -> CTCCGATCCGCCAATGCCC
GCTCCTGCAAAAGATAATC -> CTCCTGCAAAAGATAATCT
GCTCTGAGTAGAGCGTGTT -> CTCTGAGTAGAGCGTGTTG
GCTGATGCGGTAGGGTTCA -> CTGATGCGGTAGGGTTCAA
GCTGCATTTCGGGTTCGTT -> CTGCATTTCGGGTTCGTTT
GCTGCGTCGAAATTCACTC -> CTGCGTCGAAATTCACTCG
GCTGTCTACGATACTATAG -> CTGTCTACGATACTATAGC
GCTTAATCAGATGCAGTAT -> CTTAATCAGATGCAGTATA
GCTTACGACACCGAACTCC -> CTTACGACACCGAACTCCC
GCTTCGCTAGCTCAACGCT -> CTTCGCTAGCTCAACGCTA
GCTTGATGTTGCTTGTTTC -> CTTGATGTTGCTTGTTTCT
GCTTGCAAGGCGGTAGGGA -> CTTGCAAGGCGGTAGGGAA
GCTTGTTAAATGGGCTAGA -> CTTGTTAAATGGGCTAGAC
GCTTGTTTCTCGCCATGGT -> CTTGTTTCTCGCCATGGTA
GCTTTCCCGAGAGAGAGTG -> CTTTCCCGAGAGAGAGTGT
GCTTTGGAAGCTAACAACA -> CTTTGGAAGCTAACAACAA
GGAAAAGAGCCTGAATTAG -> GAAAAGAGCCTGAATTAGG
GGAAAAGCTCCATATCACT -> GAAAAGCTCCATATCACTC
GGAAAGACATCTTGGCGAC -> GAAAGACATCTTGGCGACC
GGAACAGTGATGGATGCGG -> GAACAGTGATGGATGCGGG
GGAACCATTTATTCAGGGC -> GAACCATTTATTCAGGGCC
GGAACCCACCACTCGTCAC -> GAACCCACCACTCGTCACG
GGAACGTGGAAAAGCTCCA -> GAACGTGGAAAAGCTCCAT
GGAAGAACGCGGACTTCGC -> GAAGAACGCGGACTTCGCC
GGAAGCTAACAACAAGTAA -> GAAGCTAACAACAAGTAAT
GGAAGCTAACAACAAGTAC -> GAAGCTAACAACAAGTACC
GGAAGCTAACAACAAGTAG -> GAAGCTAACAACAAGTAGA
GGAAGCTAACAACAAGTAT -> GAAGCTAACAACAAGTATA
GGAAGGGCAATCAATGGCC -> GAAGGGCAATCAATGGCCT
GGAAGGTAGTCCCTCGTTG -> GAAGGTAGTCCCTCGTTGA
GGAAGTCTAGCCTAAATTC -> GAAGTCTAGCCTAAATTCG
GGACAAATGGTGCTACTTG -> GACAAATGGTGCTACTTGG
GGACAAGAAAGAAGCGGAC -> GACAAGAAAGAAGCGGACA
GGACACTCGCGGCAGCCAA -> GACACTCGCGGCAGCCAAG
GGACATCTCCAGCGCGTAC -> GACATCTCCAGCGCGTACT
GGACGACCGATCCTTCCCG -> GACGACCGATCCTTCCCGA
GGACGATAGCAATGGTTTC -> GACGATAGCAATGGTTTCC
GGACGGGTAGCCCGGGATG -> GACGGGTAGCCCGGGATGT
GGACTCCGGGCATTCTGCT -> GACTCCGGGCATTCTGCTT
GGACTTCGCCACTCTATGA -> GACTTCGCCACTCTATGAC
GGAGCCACGTCTTACGGCC -> GAGCCACGTCTTACGGCCA
GGAGGGATGGAGCCACGTC -> GAGGGATGGAGCCACGTCT
GGAGGGCGGTCGTCCGCCC -> GAGGGCGGTCGTCCGCCCC
GGAGTATAGATCATCGGCT -> GAGTATAGATCATCGGCTA
GGATCGTCTCAGGGTGCCT -> GATCGTCTCAGGGTGCCTG
GGATCGTCTTTCAAACTGA -> GATCGTCTTTCAAACTGAA
GGATGCGGGTACCGACAAT -> GATGCGGGTACCGACAATT
GGATGGAACGTGGAAAAGC -> GATGGAACGTGGAAAAGCT
GGATGGAGCCACGTCTTAC -> GATGGAGCCACGTCTTACG
GGATGTGGGTATACATCTT -> GATGTGGGTATACATCTTA
GGCAATCAATGGCCTCTAG -> GCAATCAATGGCCTCTAGG
GGCAATTGCATAGTTGCCG -> GCAATTGCATAGTTGCCGC
GGCACCAATCTGCATCTAC -> GCACCAATCTGCATCTACA
GGCACGTAAGCTTGATGTT -> GCACGTAAGCTTGATGTTG
GGCAGCCAAGGGACATCTC -> GCAGCCAAGGGACATCTCC
GGCAGTTGGATGGAACGTG -> GCAGTTGGATGGAACGTGG
GGCATAATCGATAGCGGAT -> GCATAATCGATAGCGGATC
GGCATAGGGCTGATGCGGT -> GCATAGGGCTGATGCGGTA
GGCATTCTGCTTTGGAAGC -> GCATTCTGCTTTGGAAGCT
GGCCAAATTTCTGAACGGT -> GCCAAATTTCTGAACGGTA
GGCCACCTCACTATTGGTA -> GCCACCTCACTATTGGTAA
GGCCACGATACGGGGAACC -> GCCACGATACGGGGAACCC
GGCCAGAGGGGGTTTAATT -> GCCAGAGGGGGTTTAATTG
GGCCAGCGGAAGCTAACAA -> GCCAGCGGAAGCTAACAAC
GGCCCGGGTTCCACGGCTC -> GCCCGGGTTCCACGGCTCA
GGCCGACCCTTGAAACATG -> GCCGACCCTTGAAACATGC
GGCCGGGCACGTAAGCTTG -> GCCGGGCACGTAAGCTTGA
GGCCTACCAGGAAGCTAAC -> GCCTACCAGGAAGCTAACA
GGCCTCCCTCTTAGCACGT -> GCCTCCCTCTTAGCACGTA
GGCCTCCGTGCCGAATGTT -> GCCTCCGTGCCGAATGTTC
GGCCTCTAGGTCGGTGAGC -> GCCTCTAGGTCGGTGAGCA
GGCCTGGCCCGGGTTCCAC -> GCCTGGCCCGGGTTCCACG
GGCGACCACTCCAGTTCGA -> GCGACCACTCCAGTTCGAT
GGCGACGGAAGTCTAGCCT -> GCGACGGAAGTCTAGCCTA
GGCGAGGGAAGGGCAATCA -> GCGAGGGAAGGGCAATCAA
GGCGATACTTATTCCGTGG -> GCGATACTTATTCCGTGGG
GGCGCCAAAGGTAGGGCCG -> GCGCCAAAGGTAGGGCCGG
GGCGCCTCTGGCCGACCCT -> GCGCCTCTGGCCGACCCTT
GGCGGTAGGGAAGCTAACA -> GCGGTAGGGAAGCTAACAA
GGCGGTCGTCCGCCCCGAC -> GCGGTCGTCCGCCCCGACG
GGCGTGCTACCTCTTGCTT -> GCGTGCTACCTCTTGCTTG
GGCTAGACAAATACCGACA -> GCTAGACAAATACCGACAT
GGCTATGAAGACCCGCCGT -> GCTATGAAGACCCGCCGTA
GGCTATGCGGGTAGATTTA -> GCTATGCGGGTAGATTTAA
GGCTCATTACCAGGACGGG -> GCTCATTACCAGGACGGGT
GGCTGATGCGGTAGGGTTC -> GCTGATGCGGTAGGGTTCA
GGCTTACGACACCGAACTC -> GCTTACGACACCGAACTCC
GGGAACCCACCACTCGTCA -> GGAACCCACCACTCGTCAC
GGGAAGCTAACAACAAGTA -> GGAAGCTAACAACAAGTAG
GGGAAGGGCAATCAATGGC -> GGAAGGGCAATCAATGGCC
GGGACATCTCCAGCGCGTA -> GGACATCTCCAGCGCGTAC
GGGAGTATAGATCATCGGC -> GGAGTATAGATCATCGGCT
GGGATGGAGCCACGTCTTA -> GGATGGAGCCACGTCTTAC
GGGATGTGGGTATACATCT -> GGATGTGGGTATACATCTT
GGGCAATCAATGGCCTCTA -> GGCAATCAATGGCCTCTAG
GGGCACCAATCTGCATCTA -> GGCACCAATCTGCATCTAC
GGGCACGTAAGCTTGATGT -> GGCACGTAAGCTTGATGTT
GGGCAGTTGGATGGAACGT -> GGCAGTTGGATGGAACGTG
GGGCATTCTGCTTTGGAAG -> GGCATTCTGCTTTGGAAGC
GGGCCAAATTTCTGAACGG -> GGCCAAATTTCTGAACGGT
GGGCCAGAGGGGGTTTAAT -> GGCCAGAGGGGGTTTAATT
GGGCCAGCGGAAGCTAACA -> GGCCAGCGGAAGCTAACAA
GGGCCGGGCACGTAAGCTT -> GGCCGGGCACGTAAGCTTG
GGGCCTCCGTGCCGAATGT -> GGCCTCCGTGCCGAATGTT
GGGCGCCAAAGGTAGGGCC -> GGCGCCAAAGGTAGGGCCG
GGGCGGTCGTCCGCCCCGA -> GGCGGTCGTCCGCCCCGAC
GGGCTAGACAAATACCGAC -> GGCTAGACAAATACCGACA
GGGCTGATGCGGTAGGGTT -> GGCTGATGCGGTAGGGTTC
GGGCTTACGACACCGAACT -> GGCTTACGACACCGAACTC
GGGGAACCCACCACTCGTC -> GGGAACCCACCACTCGTCA
GGGGCACCAATCTGCATCT -> GGGCACCAATCTGCATCTA
GGGGCCAGAGGGGGTTTAA -> GGGCCAGAGGGGGTTTAAT
GGGGCCAGCGGAAGCTAAC -> GGGCCAGCGGAAGCTAACA
GGGGGCCAGAGGGGGTTTA -> GGGGCCAGAGGGGGTTTAA
GGGGGGCCAGAGGGGGTTT -> GGGGGCCAGAGGGGGTTTA
GGGGGTTTAATTGAGCTCT -> GGGGTTTAATTGAGCTCTG
GGGGTTTAATTGAGCTCTG -> GGGTTTAATTGAGCTCTGA
GGGTACCGACAATTTAGCA -> GGTACCGACAATTTAGCAA
GGGTAGATTTAATCTCCCA -> GGTAGATTTAATCTCCCAC, GGTAGATTTAATCTCCCAC
GGGTAGATTTAATCTCCCC -> GGTAGATTTAATCTCCCCG
GGGTAGATTTAATCTCCTC -> GGTAGATTTAATCTCCTCC
GGGTAGCCCGGGATGTGGG -> GGTAGCCCGGGATGTGGGT
GGGTATACATCTTAGGCGA -> GGTATACATCTTAGGCGAC
GGGTGCCTGACTTGTAATT -> GGTGCCTGACTTGTAATTC
GGGTTCAACAAGCAGGTCC -> GGTTCAACAAGCAGGTCCC
GGGTTCCACGGCTCATTAC -> GGTTCCACGGCTCATTACC
GGGTTCGTTTATGAAATCT -> GGTTCGTTTATGAAATCTG
GGGTTTAATTGAGCTCTGA -> GGTTTAATTGAGCTCTGAG
GGTAATATCGGGGGGCCAG -> GTAATATCGGGGGGCCAGA
GGTACCGACAATTTAGCAA -> GTACCGACAATTTAGCAAG
GGTACTATCCCCTGGCATA -> GTACTATCCCCTGGCATAA
GGTACTCATATTCACAGCC -> GTACTCATATTCACAGCCC
GGTACTGACGACCACCTGG -> GTACTGACGACCACCTGGG
GGTAGATTTAATCTCCCAC -> GTAGATTTAATCTCCCACC, GTAGATTTAATCTCCCACG
GGTAGATTTAATCTCCCCG -> GTAGATTTAATCTCCCCGA
GGTAGATTTAATCTCCTCC -> GTAGATTTAATCTCCTCCG
GGTAGCCAAGATATAAGTG -> GTAGCCAAGATATAAGTGA
GGTAGCCCGGGATGTGGGT -> GTAGCCCGGGATGTGGGTA
GGTAGGGAAGCTAACAACA -> GTAGGGAAGCTAACAACAA
GGTAGGGCCGGGCACGTAA -> GTAGGGCCGGGCACGTAAG
GGTAGGGTTCAACAAGCAG -> GTAGGGTTCAACAAGCAGG
GGTAGTCCCTCGTTGATGA -> GTAGTCCCTCGTTGATGAG
GGTATACATCTTAGGCGAC -> GTATACATCTTAGGCGACG
GGTATGACGCTTGCAAGGC -> GTATGACGCTTGCAAGGCG
GGTCAAAAACCACTGATAG -> GTCAAAAACCACTGATAGC
GGTCAACTACCTGGAAAAG -> GTCAACTACCTGGAAAAGA
GGTCACCATACCAGTTCTC -> GTCACCATACCAGTTCTCT
GGTCCCCACTTCGAGCCAT -> GTCCCCACTTCGAGCCATC
GGTCGGTGAGCATTTTGAG -> GTCGGTGAGCATTTTGAGT
GGTCGTCCGCCCCGACGGA -> GTCGTCCGCCCCGACGGAA
GGTGACGGTTACAAAAGGC -> GTGACGGTTACAAAAGGCC
GGTGAGCATTTTGAGTTTT -> GTGAGCATTTTGAGTTTTG
GGTGCCTGACTTGTAATTC -> GTGCCTGACTTGTAATTCA
GGTGCTACTTGGTATGACG -> GTGCTACTTGGTATGACGC
GGTTAATTGACCCCGATCA -> GTTAATTGACCCCGATCAC
GGTTACAAAAGGCCACGAT -> GTTACAAAAGGCCACGATA
GGTTCAACAAGCAGGTCCC -> GTTCAACAAGCAGGTCCCC
GGTTCCACGGCTCATTACC -> GTTCCACGGCTCATTACCA
GGTTCGTTTATGAAATCTG -> GTTCGTTTATGAAATCTGG
GGTTCTGCCAATGCCTTTA -> GTTCTGCCAATGCCTTTAG
GGTTTAATTGAGCTCTGAG -> GTTTAATTGAGCTCTGAGT
GGTTTCCGCCTTCGGTTCT -> GTTTCCGCCTTCGGTTCTG
GGTTTTGCGGGTAGATTTA -> GTTTTGCGGGTAGATTTAA
GTAAACGTTACAAAAAGCA -> TAAACGTTACAAAAAGCAC
GTAAGCTTGATGTTGCTTG -> TAAGCTTGATGTTGCTTGT
GTAAGTAAACGTTACAAAA -> TAAGTAAACGTTACAAAAA
GTAATATCGGGGGGCCAGA -> TAATATCGGGGGGCCAGAG
GTAATTCAAGCCTCTCCCA -> TAATTCAAGCCTCTCCCAG
GTAATTTAGCGAGTGCGGG -> TAATTTAGCGAGTGCGGGT
GTACCCAAAAACTTGCGGG -> TACCCAAAAACTTGCGGGT
GTACCCCGATGCCAAGAAT -> TACCCCGATGCCAAGAATG
GTACCCTGACGGCCTGGCC -> TACCCTGACGGCCTGGCCC
GTACCGACAATTTAGCAAG -> TACCGACAATTTAGCAAGA
GTACCGCTCCTGCAAAAGA -> TACCGCTCCTGCAAAAGAT
GTACGTTTCCCCTTGAATG -> TACGTTTCCCCTTGAATGA
GTACTAGCTTAATCAGATG -> TACTAGCTTAATCAGATGC
GTACTATCCCCTGGCATAA -> TACTATCCCCTGGCATAAT
GTACTATGGTACTGACGAC -> TACTATGGTACTGACGACC
GTACTCATATTCACAGCCC -> TACTCATATTCACAGCCCG
GTACTGACGACCACCTGGG -> TACTGACGACCACCTGGGA
GTAGAAGCGGTTTTGCGGG -> TAGAAGCGGTTTTGCGGGT
GTAGAGCGTGTTGGTCAAA -> TAGAGCGTGTTGGTCAAAA
GTAGATTTAATCTCCCACC -> TAGATTTAATCTCCCACCC
GTAGATTTAATCTCCCACG -> TAGATTTAATCTCCCACGA
GTAGATTTAATCTCCCCGA -> TAGATTTAATCTCCCCGAT
GTAGATTTAATCTCCTCCG -> TAGATTTAATCTCCTCCGA
GTAGCCAAGATATAAGTGA -> TAGCCAAGATATAAGTGAT
GTAGCCCGGGATGTGGGTA -> TAGCCCGGGATGTGGGTAT
GTAGCGTGATTATGGACAA -> TAGCGTGATTATGGACAAG
GTAGGAGGGCGGTCGTCCG -> TAGGAGGGCGGTCGTCCGC
GTAGGCGAGGGAAGGGCAA -> TAGGCGAGGGAAGGGCAAT
GTAGGGAAGCTAACAACAA -> TAGGGAAGCTAACAACAAG
GTAGGGCCGGGCACGTAAG -> TAGGGCCGGGCACGTAAGC
GTAGGGTTCAACAAGCAGG -> TAGGGTTCAACAAGCAGGT
GTAGTATTGATACCCAATT -> TAGTATTGATACCCAATTT
GTAGTCATACTACTGCATT -> TAGTCATACTACTGCATTA
GTAGTCCCTCGTTGATGAG -> TAGTCCCTCGTTGATGAGT
GTATACATCTTAGGCGACG -> TATACATCTTAGGCGACGG
GTATACCTGGCTATGCGGG -> TATACCTGGCTATGCGGGT
GTATACGTAGGCGAGGGAA -> TATACGTAGGCGAGGGAAG
GTATAGATCATCGGCTATG -> TATAGATCATCGGCTATGA
GTATGACGCTTGCAAGGCG -> TATGACGCTTGCAAGGCGG
GTATTCTGCATCAGTGTGC -> TATTCTGCATCAGTGTGCC
GTATTGATACCCAATTTGT -> TATTGATACCCAATTTGTT
GTCAAAAACCACTGATAGC -> TCAAAAACCACTGATAGCC
GTCAACTACCTGGAAAAGA -> TCAACTACCTGGAAAAGAG
GTCACCATACCAGTTCTCT -> TCACCATACCAGTTCTCTA
GTCACGATTTGTCGCCCTT -> TCACGATTTGTCGCCCTTT
GTCAGCAGGGCAGTTGGAT -> TCAGCAGGGCAGTTGGATG
GTCATACTACTGCATTACC -> TCATACTACTGCATTACCC
GTCCACAATCTCGTATTCT -> TCCACAATCTCGTATTCTG
GTCCAGACAAGGAAGGTAG -> TCCAGACAAGGAAGGTAGT
GTCCCACGCGTACCCCGAT -> TCCCACGCGTACCCCGATG
GTCCCCACTTCGAGCCATC -> TCCCCACTTCGAGCCATCT
GTCCCTCGTTGATGAGTGG -> TCCCTCGTTGATGAGTGGC
GTCCGCCCCGACGGAACCA -> TCCGCCCCGACGGAACCAT
GTCGAAATTCACTCGAGGA -> TCGAAATTCACTCGAGGAT
GTCGAGACGTAGTATTGAT -> TCGAGACGTAGTATTGATA
GTCGCCCAATTCACCCGGC -> TCGCCCAATTCACCCGGCG
GTCGCCCTTTGTACCCTGA -> TCGCCCTTTGTACCCTGAC
GTCGGTGAGCATTTTGAGT -> TCGGTGAGCATTTTGAGTT
GTCGTCCGCCCCGACGGAA -> TCGTCCGCCCCGACGGAAC
GTCTACGATACTATAGCGG -> TCTACGATACTATAGCGGC
GTCTAGCCTAAATTCGTCC -> TCTAGCCTAAATTCGTCCA
GTCTAGGTCACCATACCAG -> TCTAGGTCACCATACCAGT
GTCTCAGGGTGCCTGACTT -> TCTCAGGGTGCCTGACTTG
GTCTTACGGCCACCTCACT -> TCTTACGGCCACCTCACTA
GTCTTTCAAACTGAATCAG -> TCTTTCAAACTGAATCAGG
GTGACGGTTACAAAAGGCC -> TGACGGTTACAAAAGGCCA
GTGAGCATTTTGAGTTTTG -> TGAGCATTTTGAGTTTTGA
GTGAGGTCAACTACCTGGA -> TGAGGTCAACTACCTGGAA
GTGATAAGGACTCCGGGCA -> TGATAAGGACTCCGGGCAT
GTGATGGATGCGGGTACCG -> TGATGGATGCGGGTACCGA
GTGATTATGGACAAGAAAG -> TGATTATGGACAAGAAAGA
GTGCCACTATGAGCTTCGC -> TGCCACTATGAGCTTCGCT
GTGCCCCAGTACGTTTCCC -> TGCCCCAGTACGTTTCCCC
GTGCCGAATGTTCGCCAGC -> TGCCGAATGTTCGCCAGCC
GTGCCTGACTTGTAATTCA -> TGCCTGACTTGTAATTCAA
GTGCGGGTAGATTTAATCT -> TGCGGGTAGATTTAATCTC
GTGCTACCTCTTGCTTGTT -> TGCTACCTCTTGCTTGTTA
GTGCTACTTGGTATGACGC -> TGCTACTTGGTATGACGCT
GTGCTATTAAGGTACTCAT -> TGCTATTAAGGTACTCATA
GTGGAAAAGCTCCATATCA -> TGGAAAAGCTCCATATCAC
GTGGCGTGCTACCTCTTGC -> TGGCGTGCTACCTCTTGCT
GTGGGCGCCAAAGGTAGGG -> TGGGCGCCAAAGGTAGGGC
GTGGGTATACATCTTAGGC -> TGGGTATACATCTTAGGCG
GTGTGAGGTCAACTACCTG -> TGTGAGGTCAACTACCTGG
GTGTGCCCCAGTACGTTTC -> TGTGCCCCAGTACGTTTCC
GTGTTGGTCAAAAACCACT -> TGTTGGTCAAAAACCACTG
GTTAAATGGGCTAGACAAA -> TTAAATGGGCTAGACAAAT
GTTAATTGACCCCGATCAC -> TTAATTGACCCCGATCACA
GTTACAAAAAGCACTACCA -> TTACAAAAAGCACTACCAC
GTTACAAAAGGCCACGATA -> TTACAAAAGGCCACGATAC
GTTAGCTGTCTACGATACT -> TTAGCTGTCTACGATACTA
GTTCAACAAGCAGGTCCCC -> TTCAACAAGCAGGTCCCCA
GTTCCACGGCTCATTACCA -> TTCCACGGCTCATTACCAG
GTTCGAAGTCTAGGTCACC -> TTCGAAGTCTAGGTCACCA
GTTCGATGGACGACCGATC -> TTCGATGGACGACCGATCC
GTTCGCCAGCCTGAAGACG -> TTCGCCAGCCTGAAGACGT
GTTCGTTTATGAAATCTGG -> TTCGTTTATGAAATCTGGT
GTTCTCTATTGAGTCGAGA -> TTCTCTATTGAGTCGAGAC
GTTCTGCCAATGCCTTTAG -> TTCTGCCAATGCCTTTAGA
GTTGATGAGTGGCGTGCTA -> TTGATGAGTGGCGTGCTAC
GTTGCCGCGGACAAATGGT -> TTGCCGCGGACAAATGGTG
GTTGCTTGTTTCTCGCCAT -> TTGCTTGTTTCTCGCCATG
GTTGGACGATAGCAATGGT -> TTGGACGATAGCAATGGTT
GTTGGATGGAACGTGGAAA -> TTGGATGGAACGTGGAAAA
GTTGGTCAAAAACCACTGA -> TTGGTCAAAAACCACTGAT
GTTGTCGCCCAATTCACCC -> TTGTCGCCCAATTCACCCG
GTTTAAGTTGGACGATAGC -> TTTAAGTTGGACGATAGCA
GTTTAATTGAGCTCTGAGT -> TTTAATTGAGCTCTGAGTA
GTTTATGAAATCTGGTTAA -> TTTATGAAATCTGGTTAAT
GTTTCCCCTTGAATGAAGT -> TTTCCCCTTGAATGAAGTT
GTTTCCGCCTTCGGTTCTG -> TTTCCGCCTTCGGTTCTGC
GTTTCTCGCCATGGTAGCC -> TTTCTCGCCATGGTAGCCA
GTTTTCGGAGGGATGGAGC -> TTTTCGGAGGGATGGAGCC
GTTTTGAAGACTAGCCTAC -> TTTTGAAGACTAGCCTACA
GTTTTGCGGGTAGATTTAA -> TTTTGCGGGTAGATTTAAT
TAAACGTTACAAAAAGCAC -> AAACGTTACAAAAAGCACT
TAAAGCTGCATTTCGGGTT -> AAAGCTGCATTTCGGGTTC
TAAATGGGCTAGACAAATA -> AAATGGGCTAGACAAATAC
TAAATTCGTCCAGACAAGG -> AAATTCGTCCAGACAAGGA
TAACAACAAGTAATTTAGC -> AACAACAAGTAATTTAGCG
TAACAACAAGTACCCAAAA -> AACAACAAGTACCCAAAAA
TAACAACAAGTAGAAGCGG -> AACAACAAGTAGAAGCGGT
TAACAACAAGTATACCTGG -> AACAACAAGTATACCTGGC
TAAGACGGCAATTGCATAG -> AAGACGGCAATTGCATAGT
TAAGCTTGATGTTGCTTGT -> AAGCTTGATGTTGCTTGTT
TAAGGACTCCGGGCATTCT -> AAGGACTCCGGGCATTCTG
TAAGGTACTCATATTCACA -> AAGGTACTCATATTCACAG
TAAGTAAACGTTACAAAAA -> AAGTAAACGTTACAAAAAG
TAAGTGATAAGGACTCCGG -> AAGTGATAAGGACTCCGGG
TAAGTTGGACGATAGCAAT -> AAGTTGGACGATAGCAATG
TAATAAAGCTGCATTTCGG -> AATAAAGCTGCATTTCGGG
TAATATCGGGGGGCCAGAG -> AATATCGGGGGGCCAGAGG
TAATCAGATGCAGTATACG -> AATCAGATGCAGTATACGT
TAATCGATAGCGGATCGTC -> AATCGATAGCGGATCGTCT
TAATCTCCCACCCGCTCCG -> AATCTCCCACCCGCTCCGA
TAATCTCCCACGAGCCCAG -> AATCTCCCACGAGCCCAGA
TAATCTCCCCGATTCATCT -> AATCTCCCCGATTCATCTA
TAATCTCCTCCGACGGAAG -> AATCTCCTCCGACGGAAGA
TAATCTCTACCAGGCCTCC -> AATCTCTACCAGGCCTCCC
TAATGCCGATCGTCAGCAG -> AATGCCGATCGTCAGCAGG
TAATTCAAGCCTCTCCCAG -> AATTCAAGCCTCTCCCAGT
TAATTGACCCCGATCACAT -> AATTGACCCCGATCACATG
TAATTGAGCTCTGAGTAGA -> AATTGAGCTCTGAGTAGAG
TAATTTAGCGAGTGCGGGT -> AATTTAGCGAGTGCGGGTA
TACAAAAAGCACTACCACC -> ACAAAAAGCACTACCACCC
TACAAAAGGCCACGATACG -> ACAAAAGGCCACGATACGG
TACAAAGGTAAATTAGAGT -> ACAAAGGTAAATTAGAGTG
TACATATTGCCGTTCGAAG -> ACATATTGCCGTTCGAAGT
TACATCTTAGGCGACGGAA -> ACATCTTAGGCGACGGAAG
TACCACCCAATAATAAAGC -> ACCACCCAATAATAAAGCT
TACCAGGAAGCTAACAACA -> ACCAGGAAGCTAACAACAA
TACCAGGACGGGTAGCCCG -> ACCAGGACGGGTAGCCCGG
TACCAGGCCTCCCTCTTAG -> ACCAGGCCTCCCTCTTAGC
TACCAGTTCTCTATTGAGT -> ACCAGTTCTCTATTGAGTC
TACCCAAAAACTTGCGGGT -> ACCCAAAAACTTGCGGGTA
TACCCAATTTGTTAGCTGT -> ACCCAATTTGTTAGCTGTC
TACCCCGATGCCAAGAATG -> ACCCCGATGCCAAGAATGC
TACCCTCTGGGGCACCAAT -> ACCCTCTGGGGCACCAATC
TACCCTGACGGCCTGGCCC -> ACCCTGACGGCCTGGCCCG
TACCGACAATTTAGCAAGA -> ACCGACAATTTAGCAAGAT
TACCGACATTTAGTTGTCG -> ACCGACATTTAGTTGTCGC
TACCGCTCCTGCAAAAGAT -> ACCGCTCCTGCAAAAGATA
TACCTCTTGCTTGTTAAAT -> ACCTCTTGCTTGTTAAATG
TACCTGGAAAAGAGCCTGA -> ACCTGGAAAAGAGCCTGAA
TACCTGGCTATGCGGGTAG -> ACCTGGCTATGCGGGTAGA
TACGACACCGAACTCCCGC -> ACGACACCGAACTCCCGCA
TACGATACTATAGCGGCGA -> ACGATACTATAGCGGCGAT
TACGCACCTCTTAAGACGG -> ACGCACCTCTTAAGACGGC
TACGGCCACCTCACTATTG -> ACGGCCACCTCACTATTGG
TACGGGGAACCCACCACTC -> ACGGGGAACCCACCACTCG
TACGTAGGCGAGGGAAGGG -> ACGTAGGCGAGGGAAGGGC
TACGTTTCCCCTTGAATGA -> ACGTTTCCCCTTGAATGAA
TACTACTGCATTACCCTCT -> ACTACTGCATTACCCTCTG
TACTAGCTTAATCAGATGC -> ACTAGCTTAATCAGATGCA
TACTATAGCGGCGATACTT -> ACTATAGCGGCGATACTTA
TACTATCCCCTGGCATAAT -> ACTATCCCCTGGCATAATC
TACTATGGTACTGACGACC -> ACTATGGTACTGACGACCA
TACTCATATTCACAGCCCG -> ACTCATATTCACAGCCCGT
TACTCCTATTCATCGCCAG -> ACTCCTATTCATCGCCAGG
TACTGACGACCACCTGGGA -> ACTGACGACCACCTGGGAG
TACTGCATTACCCTCTGGG -> ACTGCATTACCCTCTGGGG
TACTTATTCCGTGGGCGCC -> ACTTATTCCGTGGGCGCCA
TACTTGGTATGACGCTTGC -> ACTTGGTATGACGCTTGCA
TAGAAACCGGCCTACCAGG -> AGAAACCGGCCTACCAGGA
TAGAAGCGGTTTTGCGGGT -> AGAAGCGGTTTTGCGGGTA
TAGAATTCTGTAAGTAAAC -> AGAATTCTGTAAGTAAACG
TAGACAAATACCGACATTT -> AGACAAATACCGACATTTA
TAGAGCGTGTTGGTCAAAA -> AGAGCGTGTTGGTCAAAAA
TAGATCATCGGCTATGAAG -> AGATCATCGGCTATGAAGA
TAGATTTAATCTCCCACCC -> AGATTTAATCTCCCACCCG
TAGATTTAATCTCCCACGA -> AGATTTAATCTCCCACGAG
TAGATTTAATCTCCCCGAT -> AGATTTAATCTCCCCGATT
TAGATTTAATCTCCTCCGA -> AGATTTAATCTCCTCCGAC
TAGCAAGATTTATGAACAC -> AGCAAGATTTATGAACACG
TAGCAATGGTTTCCGCCTT -> AGCAATGGTTTCCGCCTTC
TAGCACGTACTAGCTTAAT -> AGCACGTACTAGCTTAATC
TAGCCAAGATATAAGTGAT -> AGCCAAGATATAAGTGATA
TAGCCCGGGATGTGGGTAT -> AGCCCGGGATGTGGGTATA
TAGCCCTAATGCCGATCGT -> AGCCCTAATGCCGATCGTC
TAGCCTAAATTCGTCCAGA -> AGCCTAAATTCGTCCAGAC
TAGCCTACAAAGGTAAATT -> AGCCTACAAAGGTAAATTA
TAGCGAGTGCGGGTAGATT -> AGCGAGTGCGGGTAGATTT
TAGCGGATCGTCTTTCAAA -> AGCGGATCGTCTTTCAAAC
TAGCGGCGATACTTATTCC -> AGCGGCGATACTTATTCCG
TAGCGTCCCACGCGTACCC -> AGCGTCCCACGCGTACCCC
TAGCGTGATTATGGACAAG -> AGCGTGATTATGGACAAGA
TAGCTCAACGCTATGCCGG -> AGCTCAACGCTATGCCGGA
TAGCTGTCTACGATACTAT -> AGCTGTCTACGATACTATA
TAGCTTAATCAGATGCAGT -> AGCTTAATCAGATGCAGTA
TAGGAACAGTGATGGATGC -> AGGAACAGTGATGGATGCG
TAGGAGGGCGGTCGTCCGC -> AGGAGGGCGGTCGTCCGCC
TAGGCGACGGAAGTCTAGC -> AGGCGACGGAAGTCTAGCC
TAGGCGAGGGAAGGGCAAT -> AGGCGAGGGAAGGGCAATC
TAGGGAAGCTAACAACAAG -> AGGGAAGCTAACAACAAGT
TAGGGCCGGGCACGTAAGC -> AGGGCCGGGCACGTAAGCT
TAGGGCTGATGCGGTAGGG -> AGGGCTGATGCGGTAGGGT
TAGGGTTCAACAAGCAGGT -> AGGGTTCAACAAGCAGGTC
TAGGTCACCATACCAGTTC -> AGGTCACCATACCAGTTCT
TAGGTCGGTGAGCATTTTG -> AGGTCGGTGAGCATTTTGA
TAGTATTGATACCCAATTT -> AGTATTGATACCCAATTTG
TAGTCATACTACTGCATTA -> AGTCATACTACTGCATTAC
TAGTCCCTCGTTGATGAGT -> AGTCCCTCGTTGATGAGTG
TAGTTGCCGCGGACAAATG -> AGTTGCCGCGGACAAATGG
TAGTTGTCGCCCAATTCAC -> AGTTGTCGCCCAATTCACC
TATAAGTGATAAGGACTCC -> ATAAGTGATAAGGACTCCG
TATACATCTTAGGCGACGG -> ATACATCTTAGGCGACGGA
TATACCTGGCTATGCGGGT -> ATACCTGGCTATGCGGGTA
TATACGTAGGCGAGGGAAG -> ATACGTAGGCGAGGGAAGG
TATAGATCATCGGCTATGA -> ATAGATCATCGGCTATGAA
TATAGCGGCGATACTTATT -> ATAGCGGCGATACTTATTC
TATCACTCACTAGCGTCCC -> ATCACTCACTAGCGTCCCA
TATCCCCTGGCATAATCGA -> ATCCCCTGGCATAATCGAT
TATCGGGGGGCCAGAGGGG -> ATCGGGGGGCCAGAGGGGG
TATGAAATCTGGTTAATTG -> ATGAAATCTGGTTAATTGA
TATGAACACGCCCCAGTCC -> ATGAACACGCCCCAGTCCA
TATGAAGACCCGCCGTAGT -> ATGAAGACCCGCCGTAGTC
TATGACGCTTGCAAGGCGG -> ATGACGCTTGCAAGGCGGT
TATGACTGATAGAATTCTG -> ATGACTGATAGAATTCTGT
TATGAGCTTCGCTAGCTCA -> ATGAGCTTCGCTAGCTCAA
TATGCCGGAAAGACATCTT -> ATGCCGGAAAGACATCTTG
TATGCGGGTAGATTTAATC -> ATGCGGGTAGATTTAATCT
TATGGACAAGAAAGAAGCG -> ATGGACAAGAAAGAAGCGG
TATGGTACTGACGACCACC -> ATGGTACTGACGACCACCT
TATTAAGGTACTCATATTC -> ATTAAGGTACTCATATTCA
TATTCACAGCCCGTAGCGT -> ATTCACAGCCCGTAGCGTG
TATTCAGGGCCTCCGTGCC -> ATTCAGGGCCTCCGTGCCG
TATTCATCGCCAGGGGCCA -> ATTCATCGCCAGGGGCCAG
TATTCCGTGGGCGCCAAAG -> ATTCCGTGGGCGCCAAAGG
TATTCTGCATCAGTGTGCC -> ATTCTGCATCAGTGTGCCC
TATTGAGTCGAGACGTAGT -> ATTGAGTCGAGACGTAGTA
TATTGATACCCAATTTGTT -> ATTGATACCCAATTTGTTA
TATTGCCGTTCGAAGTCTA -> ATTGCCGTTCGAAGTCTAG
TATTGGTAATATCGGGGGG -> ATTGGTAATATCGGGGGGC
TCAAAAACCACTGATAGCC -> CAAAAACCACTGATAGCCC
TCAAACTGAATCAGGCATA -> CAAACTGAATCAGGCATAG
TCAACAAGCAGGTCCCCAC -> CAACAAGCAGGTCCCCACT
TCAACGCTATGCCGGAAAG -> CAACGCTATGCCGGAAAGA
TCAACTACCTGGAAAAGAG -> CAACTACCTGGAAAAGAGC
TCAAGCCTCTCCCAGTTTT -> CAAGCCTCTCCCAGTTTTC
TCAATGGCCTCTAGGTCGG -> CAATGGCCTCTAGGTCGGT
TCACAGCCCGTAGCGTGAT -> CACAGCCCGTAGCGTGATT
TCACATGTGCTATTAAGGT -> CACATGTGCTATTAAGGTA
TCACCATACCAGTTCTCTA -> CACCATACCAGTTCTCTAT
TCACCCGGCGCCTCTGGCC -> CACCCGGCGCCTCTGGCCG
TCACGATTTGTCGCCCTTT -> CACGATTTGTCGCCCTTTG
TCACTAGCGTCCCACGCGT -> CACTAGCGTCCCACGCGTA
TCACTATTGGTAATATCGG -> CACTATTGGTAATATCGGG
TCACTCACTAGCGTCCCAC -> CACTCACTAGCGTCCCACG
TCACTCGAGGATCGTCTCA -> CACTCGAGGATCGTCTCAG
TCAGATGCAGTATACGTAG -> CAGATGCAGTATACGTAGG
TCAGCAGGGCAGTTGGATG -> CAGCAGGGCAGTTGGATGG
TCAGGCATAGGGCTGATGC -> CAGGCATAGGGCTGATGCG
TCAGGGCCTCCGTGCCGAA -> CAGGGCCTCCGTGCCGAAT
TCAGGGTGCCTGACTTGTA -> CAGGGTGCCTGACTTGTAA
TCAGTGTGCCCCAGTACGT -> CAGTGTGCCCCAGTACGTT
TCATACTACTGCATTACCC -> CATACTACTGCATTACCCT
TCATATTCACAGCCCGTAG -> CATATTCACAGCCCGTAGC
TCATCGCCAGGGGCCAGCG -> CATCGCCAGGGGCCAGCGG
TCATCGGCTATGAAGACCC -> CATCGGCTATGAAGACCCG
TCATCTACGCACCTCTTAA -> CATCTACGCACCTCTTAAG
TCATTACCAGGACGGGTAG -> CATTACCAGGACGGGTAGC
TCCACAATCTCGTATTCTG -> CCACAATCTCGTATTCTGC
TCCACGGCTCATTACCAGG -> CCACGGCTCATTACCAGGA
TCCAGACAAGGAAGGTAGT -> CCAGACAAGGAAGGTAGTC
TCCAGCGCGTACTATGGTA -> CCAGCGCGTACTATGGTAC
TCCAGTTCGATGGACGACC -> CCAGTTCGATGGACGACCG
TCCATATCACTCACTAGCG -> CCATATCACTCACTAGCGT
TCCCACCCGCTCCGATCCG -> CCCACCCGCTCCGATCCGC
TCCCACGAGCCCAGAGATA -> CCCACGAGCCCAGAGATAC
TCCCACGCGTACCCCGATG -> CCCACGCGTACCCCGATGC
TCCCAGTTTTCGGAGGGAT -> CCCAGTTTTCGGAGGGATG
TCCCCACTTCGAGCCATCT -> CCCCACTTCGAGCCATCTT
TCCCCGATTCATCTACGCA -> CCCCGATTCATCTACGCAC
TCCCCTGGCATAATCGATA -> CCCCTGGCATAATCGATAG
TCCCCTTGAATGAAGTTTA -> CCCCTTGAATGAAGTTTAA
TCCCGAATGGGCCAAATTT -> CCCGAATGGGCCAAATTTC
TCCCGAGAGAGAGTGTGAG -> CCCGAGAGAGAGTGTGAGG
TCCCGCAATGTACCGCTCC -> CCCGCAATGTACCGCTCCT
TCCCTCGTTGATGAGTGGC -> CCCTCGTTGATGAGTGGCG
TCCCTCTTAGCACGTACTA -> CCCTCTTAGCACGTACTAG
TCCGACGGAAGAACGCGGA -> CCGACGGAAGAACGCGGAC
TCCGATCCGCCAATGCCCC -> CCGATCCGCCAATGCCCCT
TCCGCCAATGCCCCTCGCT -> CCGCCAATGCCCCTCGCTG
TCCGCCCCGACGGAACCAT -> CCGCCCCGACGGAACCATT
TCCGCCTTCGGTTCTGCCA -> CCGCCTTCGGTTCTGCCAA
TCCGCGGGCTTACGACACC -> CCGCGGGCTTACGACACCG
TCCGGGCATTCTGCTTTGG -> CCGGGCATTCTGCTTTGGA
TCCGTGCCGAATGTTCGCC -> CCGTGCCGAATGTTCGCCA
TCCGTGGGCGCCAAAGGTA -> CCGTGGGCGCCAAAGGTAG
TCCTATTCATCGCCAGGGG -> CCTATTCATCGCCAGGGGC
TCCTCCGACGGAAGAACGC -> CCTCCGACGGAAGAACGCG
TCCTGCAAAAGATAATCTC -> CCTGCAAAAGATAATCTCT
TCCTTCCCGAATGGGCCAA -> CCTTCCCGAATGGGCCAAA
TCGAAATTCACTCGAGGAT -> CGAAATTCACTCGAGGATC
TCGAAGTCTAGGTCACCAT -> CGAAGTCTAGGTCACCATA
TCGAGACGTAGTATTGATA -> CGAGACGTAGTATTGATAC
TCGAGCCATCTTTGGTGAC -> CGAGCCATCTTTGGTGACG
TCGAGGATCGTCTCAGGGT -> CGAGGATCGTCTCAGGGTG
TCGATAGCGGATCGTCTTT -> CGATAGCGGATCGTCTTTC
TCGATGGACGACCGATCCT -> CGATGGACGACCGATCCTT
TCGCCACTCTATGACTGAT -> CGCCACTCTATGACTGATA
TCGCCAGCCTGAAGACGTG -> CGCCAGCCTGAAGACGTGC
TCGCCAGGGGCCAGCGGAA -> CGCCAGGGGCCAGCGGAAG
TCGCCATGGTAGCCAAGAT -> CGCCATGGTAGCCAAGATA
TCGCCCAATTCACCCGGCG -> CGCCCAATTCACCCGGCGC
TCGCCCTTTGTACCCTGAC -> CGCCCTTTGTACCCTGACG
TCGCGGCAGCCAAGGGACA -> CGCGGCAGCCAAGGGACAT
TCGCTAGCTCAACGCTATG -> CGCTAGCTCAACGCTATGC
TCGCTGCGTCGAAATTCAC -> CGCTGCGTCGAAATTCACT
TCGGAGGGATGGAGCCACG -> CGGAGGGATGGAGCCACGT
TCGGCTATGAAGACCCGCC -> CGGCTATGAAGACCCGCCG
TCGGGGGGCCAGAGGGGGT -> CGGGGGGCCAGAGGGGGTT
TCGGGTTCGTTTATGAAAT -> CGGGTTCGTTTATGAAATC
TCGGTGAGCATTTTGAGTT -> CGGTGAGCATTTTGAGTTT
TCGGTTCTGCCAATGCCTT -> CGGTTCTGCCAATGCCTTT
TCGTATTCTGCATCAGTGT -> CGTATTCTGCATCAGTGTG
TCGTCACGATTTGTCGCCC -> CGTCACGATTTGTCGCCCT
TCGTCAGCAGGGCAGTTGG -> CGTCAGCAGGGCAGTTGGA
TCGTCCAGACAAGGAAGGT -> CGTCCAGACAAGGAAGGTA
TCGTCCGCCCCGACGGAAC -> CGTCCGCCCCGACGGAACC
TCGTCTCAGGGTGCCTGAC -> CGTCTCAGGGTGCCTGACT
TCGTCTTTCAAACTGAATC -> CGTCTTTCAAACTGAATCA
TCGTTGATGAGTGGCGTGC -> CGTTGATGAGTGGCGTGCT
TCGTTTATGAAATCTGGTT -> CGTTTATGAAATCTGGTTA
TCTACATATTGCCGTTCGA -> CTACATATTGCCGTTCGAA
TCTACCAGGCCTCCCTCTT -> CTACCAGGCCTCCCTCTTA
TCTACGATACTATAGCGGC -> CTACGATACTATAGCGGCG
TCTACGCACCTCTTAAGAC -> CTACGCACCTCTTAAGACG
TCTAGCCTAAATTCGTCCA -> CTAGCCTAAATTCGTCCAG
TCTAGGTCACCATACCAGT -> CTAGGTCACCATACCAGTT
TCTAGGTCGGTGAGCATTT -> CTAGGTCGGTGAGCATTTT
TCTATGACTGATAGAATTC -> CTATGACTGATAGAATTCT
TCTATTGAGTCGAGACGTA -> CTATTGAGTCGAGACGTAG
TCTCAGGGTGCCTGACTTG -> CTCAGGGTGCCTGACTTGT
TCTCCAGCGCGTACTATGG -> CTCCAGCGCGTACTATGGT
TCTCCCACCCGCTCCGATC -> CTCCCACCCGCTCCGATCC
TCTCCCACGAGCCCAGAGA -> CTCCCACGAGCCCAGAGAT
TCTCCCAGTTTTCGGAGGG -> CTCCCAGTTTTCGGAGGGA
TCTCCCCGATTCATCTACG -> CTCCCCGATTCATCTACGC
TCTCCTCCGACGGAAGAAC -> CTCCTCCGACGGAAGAACG
TCTCGCCATGGTAGCCAAG -> CTCGCCATGGTAGCCAAGA
TCTCGTATTCTGCATCAGT -> CTCGTATTCTGCATCAGTG
TCTCTACCAGGCCTCCCTC -> CTCTACCAGGCCTCCCTCT
TCTCTATTGAGTCGAGACG -> CTCTATTGAGTCGAGACGT
TCTGAACGGTACTATCCCC -> CTGAACGGTACTATCCCCT
TCTGAGTAGAGCGTGTTGG -> CTGAGTAGAGCGTGTTGGT
TCTGCATCAGTGTGCCCCA -> CTGCATCAGTGTGCCCCAG
TCTGCATCTACATATTGCC -> CTGCATCTACATATTGCCG
TCTGCCAATGCCTTTAGAA -> CTGCCAATGCCTTTAGAAA
TCTGCTTTGGAAGCTAACA -> CTGCTTTGGAAGCTAACAA
TCTGGCCGACCCTTGAAAC -> CTGGCCGACCCTTGAAACA
TCTGGGGCACCAATCTGCA -> CTGGGGCACCAATCTGCAT
TCTGGTTAATTGACCCCGA -> CTGGTTAATTGACCCCGAT
TCTGTAAGTAAACGTTACA -> CTGTAAGTAAACGTTACAA
TCTTAAGACGGCAATTGCA -> CTTAAGACGGCAATTGCAT
TCTTACGGCCACCTCACTA -> CTTACGGCCACCTCACTAT
TCTTAGCACGTACTAGCTT -> CTTAGCACGTACTAGCTTA
TCTTAGGCGACGGAAGTCT -> CTTAGGCGACGGAAGTCTA
TCTTGCTTGTTAAATGGGC -> CTTGCTTGTTAAATGGGCT
TCTTGGCGACCACTCCAGT -> CTTGGCGACCACTCCAGTT
TCTTTCAAACTGAATCAGG -> CTTTCAAACTGAATCAGGC
TCTTTGGTGACGGTTACAA -> CTTTGGTGACGGTTACAAA
TGAAACATGCTTTCCCGAG -> GAAACATGCTTTCCCGAGA
TGAAATCTGGTTAATTGAC -> GAAATCTGGTTAATTGACC
TGAACACGCCCCAGTCCAC -> GAACACGCCCCAGTCCACA
TGAACGGTACTATCCCCTG -> GAACGGTACTATCCCCTGG
TGAAGACCCGCCGTAGTCA -> GAAGACCCGCCGTAGTCAT
TGAAGACGTGCCACTATGA -> GAAGACGTGCCACTATGAG
TGAAGACTAGCCTACAAAG -> GAAGACTAGCCTACAAAGG
TGAAGTTTAAGTTGGACGA -> GAAGTTTAAGTTGGACGAT
TGAATCAGGCATAGGGCTG -> GAATCAGGCATAGGGCTGA
TGAATGAAGTTTAAGTTGG -> GAATGAAGTTTAAGTTGGA
TGAATTAGGAACAGTGATG -> GAATTAGGAACAGTGATGG
TGACCCCGATCACATGTGC -> GACCCCGATCACATGTGCT
TGACGACCACCTGGGAGTA -> GACGACCACCTGGGAGTAT
TGACGCTTGCAAGGCGGTA -> GACGCTTGCAAGGCGGTAG
TGACGGCCTGGCCCGGGTT -> GACGGCCTGGCCCGGGTTC
TGACGGTTACAAAAGGCCA -> GACGGTTACAAAAGGCCAC
TGACTGATAGAATTCTGTA -> GACTGATAGAATTCTGTAA
TGACTTGTAATTCAAGCCT -> GACTTGTAATTCAAGCCTC
TGAGCATTTTGAGTTTTGA -> GAGCATTTTGAGTTTTGAA
TGAGCTCTGAGTAGAGCGT -> GAGCTCTGAGTAGAGCGTG
TGAGCTTCGCTAGCTCAAC -> GAGCTTCGCTAGCTCAACG
TGAGGTCAACTACCTGGAA -> GAGGTCAACTACCTGGAAA
TGAGTAGAGCGTGTTGGTC -> GAGTAGAGCGTGTTGGTCA
TGAGTCGAGACGTAGTATT -> GAGTCGAGACGTAGTATTG
TGAGTGGCGTGCTACCTCT -> GAGTGGCGTGCTACCTCTT
TGAGTTTTGAAGACTAGCC -> GAGTTTTGAAGACTAGCCT
TGATAAGGACTCCGGGCAT -> GATAAGGACTCCGGGCATT
TGATACCCAATTTGTTAGC -> GATACCCAATTTGTTAGCT
TGATAGAATTCTGTAAGTA -> GATAGAATTCTGTAAGTAA
TGATAGCCCTAATGCCGAT -> GATAGCCCTAATGCCGATC
TGATGAGTGGCGTGCTACC -> GATGAGTGGCGTGCTACCT
TGATGCGGTAGGGTTCAAC -> GATGCGGTAGGGTTCAACA
TGATGGATGCGGGTACCGA -> GATGGATGCGGGTACCGAC
TGATGTTGCTTGTTTCTCG -> GATGTTGCTTGTTTCTCGC
TGATTATGGACAAGAAAGA -> GATTATGGACAAGAAAGAA
TGCAAAAGATAATCTCTAC -> GCAAAAGATAATCTCTACC
TGCAAGGCGGTAGGGAAGC -> GCAAGGCGGTAGGGAAGCT
TGCAGTATACGTAGGCGAG -> GCAGTATACGTAGGCGAGG
TGCATAGTTGCCGCGGACA -> GCATAGTTGCCGCGGACAA
TGCATCAGTGTGCCCCAGT -> GCATCAGTGTGCCCCAGTA
TGCATCTACATATTGCCGT -> GCATCTACATATTGCCGTT
TGCATTACCCTCTGGGGCA -> GCATTACCCTCTGGGGCAC
TGCATTCCGCGGGCTTACG -> GCATTCCGCGGGCTTACGA
TGCATTTCGGGTTCGTTTA -> GCATTTCGGGTTCGTTTAT
TGCCAAGAATGCATTCCGC -> GCCAAGAATGCATTCCGCG
TGCCAATGCCTTTAGAAAC -> GCCAATGCCTTTAGAAACC
TGCCACTATGAGCTTCGCT -> GCCACTATGAGCTTCGCTA
TGCCCCAGTACGTTTCCCC -> GCCCCAGTACGTTTCCCCT
TGCCCCTCGCTGCGTCGAA -> GCCCCTCGCTGCGTCGAAA
TGCCGAATGTTCGCCAGCC -> GCCGAATGTTCGCCAGCCT
TGCCGATCGTCAGCAGGGC -> GCCGATCGTCAGCAGGGCA
TGCCGCGGACAAATGGTGC -> GCCGCGGACAAATGGTGCT
TGCCGGAAAGACATCTTGG -> GCCGGAAAGACATCTTGGC
TGCCGTTCGAAGTCTAGGT -> GCCGTTCGAAGTCTAGGTC
TGCCTGACTTGTAATTCAA -> GCCTGACTTGTAATTCAAG
TGCCTTTAGAAACCGGCCT -> GCCTTTAGAAACCGGCCTA
TGCGGGTACCGACAATTTA -> GCGGGTACCGACAATTTAG
TGCGGGTAGATTTAATCTC -> GCGGGTAGATTTAATCTCC, GCGGGTAGATTTAATCTCC, GCGGGTAGATTTAATCTCC, GCGGGTAGATTTAATCTCC
TGCGGTAGGGTTCAACAAG -> GCGGTAGGGTTCAACAAGC
TGCGTCGAAATTCACTCGA -> GCGTCGAAATTCACTCGAG
TGCTACCTCTTGCTTGTTA -> GCTACCTCTTGCTTGTTAA
TGCTACTTGGTATGACGCT -> GCTACTTGGTATGACGCTT
TGCTATTAAGGTACTCATA -> GCTATTAAGGTACTCATAT
TGCTTGTTAAATGGGCTAG -> GCTTGTTAAATGGGCTAGA
TGCTTGTTTCTCGCCATGG -> GCTTGTTTCTCGCCATGGT
TGCTTTCCCGAGAGAGAGT -> GCTTTCCCGAGAGAGAGTG
TGCTTTGGAAGCTAACAAC -> GCTTTGGAAGCTAACAACA
TGGAAAAGAGCCTGAATTA -> GGAAAAGAGCCTGAATTAG
TGGAAAAGCTCCATATCAC -> GGAAAAGCTCCATATCACT
TGGAACGTGGAAAAGCTCC -> GGAACGTGGAAAAGCTCCA
TGGAAGCTAACAACAAGTA -> GGAAGCTAACAACAAGTAT
TGGACAAGAAAGAAGCGGA -> GGACAAGAAAGAAGCGGAC
TGGACGACCGATCCTTCCC -> GGACGACCGATCCTTCCCG
TGGACGATAGCAATGGTTT -> GGACGATAGCAATGGTTTC
TGGAGCCACGTCTTACGGC -> GGAGCCACGTCTTACGGCC
TGGATGCGGGTACCGACAA -> GGATGCGGGTACCGACAAT
TGGATGGAACGTGGAAAAG -> GGATGGAACGTGGAAAAGC
TGGCATAATCGATAGCGGA -> GGCATAATCGATAGCGGAT
TGGCCCGGGTTCCACGGCT -> GGCCCGGGTTCCACGGCTC
TGGCCGACCCTTGAAACAT -> GGCCGACCCTTGAAACATG
TGGCCTCTAGGTCGGTGAG -> GGCCTCTAGGTCGGTGAGC
TGGCGACCACTCCAGTTCG -> GGCGACCACTCCAGTTCGA
TGGCGTGCTACCTCTTGCT -> GGCGTGCTACCTCTTGCTT
TGGCTATGCGGGTAGATTT -> GGCTATGCGGGTAGATTTA
TGGGAGTATAGATCATCGG -> GGGAGTATAGATCATCGGC
TGGGCCAAATTTCTGAACG -> GGGCCAAATTTCTGAACGG
TGGGCGCCAAAGGTAGGGC -> GGGCGCCAAAGGTAGGGCC
TGGGCTAGACAAATACCGA -> GGGCTAGACAAATACCGAC
TGGGGCACCAATCTGCATC -> GGGGCACCAATCTGCATCT
TGGGTATACATCTTAGGCG -> GGGTATACATCTTAGGCGA
TGGTAATATCGGGGGGCCA -> GGTAATATCGGGGGGCCAG
TGGTACTGACGACCACCTG -> GGTACTGACGACCACCTGG
TGGTAGCCAAGATATAAGT -> GGTAGCCAAGATATAAGTG
TGGTATGACGCTTGCAAGG -> GGTATGACGCTTGCAAGGC
TGGTCAAAAACCACTGATA -> GGTCAAAAACCACTGATAG
TGGTGACGGTTACAAAAGG -> GGTGACGGTTACAAAAGGC
TGGTGCTACTTGGTATGAC -> GGTGCTACTTGGTATGACG
TGGTTAATTGACCCCGATC -> GGTTAATTGACCCCGATCA
TGGTTTCCGCCTTCGGTTC -> GGTTTCCGCCTTCGGTTCT
TGTAAGTAAACGTTACAAA -> GTAAGTAAACGTTACAAAA
TGTAATTCAAGCCTCTCCC -> GTAATTCAAGCCTCTCCCA
TGTACCCTGACGGCCTGGC -> GTACCCTGACGGCCTGGCC
TGTACCGCTCCTGCAAAAG -> GTACCGCTCCTGCAAAAGA
TGTCGCCCAATTCACCCGG -> GTCGCCCAATTCACCCGGC
TGTCGCCCTTTGTACCCTG -> GTCGCCCTTTGTACCCTGA
TGTCTACGATACTATAGCG -> GTCTACGATACTATAGCGG
TGTGAGGTCAACTACCTGG -> GTGAGGTCAACTACCTGGA
TGTGCCCCAGTACGTTTCC -> GTGCCCCAGTACGTTTCCC
TGTGCTATTAAGGTACTCA -> GTGCTATTAAGGTACTCAT
TGTGGGTATACATCTTAGG -> GTGGGTATACATCTTAGGC
TGTTAAATGGGCTAGACAA -> GTTAAATGGGCTAGACAAA
TGTTAGCTGTCTACGATAC -> GTTAGCTGTCTACGATACT
TGTTCGCCAGCCTGAAGAC -> GTTCGCCAGCCTGAAGACG
TGTTGCTTGTTTCTCGCCA -> GTTGCTTGTTTCTCGCCAT
TGTTGGTCAAAAACCACTG -> GTTGGTCAAAAACCACTGA
TGTTTCTCGCCATGGTAGC -> GTTTCTCGCCATGGTAGCC
TTAAATGGGCTAGACAAAT -> TAAATGGGCTAGACAAATA
TTAAGACGGCAATTGCATA -> TAAGACGGCAATTGCATAG
TTAAGGTACTCATATTCAC -> TAAGGTACTCATATTCACA
TTAAGTTGGACGATAGCAA -> TAAGTTGGACGATAGCAAT
TTAATCAGATGCAGTATAC -> TAATCAGATGCAGTATACG
TTAATCTCCCACCCGCTCC -> TAATCTCCCACCCGCTCCG
TTAATCTCCCACGAGCCCA -> TAATCTCCCACGAGCCCAG
TTAATCTCCCCGATTCATC -> TAATCTCCCCGATTCATCT
TTAATCTCCTCCGACGGAA -> TAATCTCCTCCGACGGAAG
TTAATTGACCCCGATCACA -> TAATTGACCCCGATCACAT
TTAATTGAGCTCTGAGTAG -> TAATTGAGCTCTGAGTAGA
TTACAAAAAGCACTACCAC -> TACAAAAAGCACTACCACC
TTACAAAAGGCCACGATAC -> TACAAAAGGCCACGATACG
TTACCAGGACGGGTAGCCC -> TACCAGGACGGGTAGCCCG
TTACCCTCTGGGGCACCAA -> TACCCTCTGGGGCACCAAT
TTACGACACCGAACTCCCG -> TACGACACCGAACTCCCGC
TTACGGCCACCTCACTATT -> TACGGCCACCTCACTATTG
TTAGAAACCGGCCTACCAG -> TAGAAACCGGCCTACCAGG
TTAGCAAGATTTATGAACA -> TAGCAAGATTTATGAACAC
TTAGCACGTACTAGCTTAA -> TAGCACGTACTAGCTTAAT
TTAGCGAGTGCGGGTAGAT -> TAGCGAGTGCGGGTAGATT
TTAGCTGTCTACGATACTA -> TAGCTGTCTACGATACTAT
TTAGGAACAGTGATGGATG -> TAGGAACAGTGATGGATGC
TTAGGCGACGGAAGTCTAG -> TAGGCGACGGAAGTCTAGC
TTAGTTGTCGCCCAATTCA -> TAGTTGTCGCCCAATTCAC
TTATGAAATCTGGTTAATT -> TATGAAATCTGGTTAATTG
TTATGAACACGCCCCAGTC -> TATGAACACGCCCCAGTCC
TTATGGACAAGAAAGAAGC -> TATGGACAAGAAAGAAGCG
TTATTCAGGGCCTCCGTGC -> TATTCAGGGCCTCCGTGCC
TTATTCCGTGGGCGCCAAA -> TATTCCGTGGGCGCCAAAG
TTCAAACTGAATCAGGCAT -> TCAAACTGAATCAGGCATA
TTCAACAAGCAGGTCCCCA -> TCAACAAGCAGGTCCCCAC
TTCAAGCCTCTCCCAGTTT -> TCAAGCCTCTCCCAGTTTT
TTCACAGCCCGTAGCGTGA -> TCACAGCCCGTAGCGTGAT
TTCACCCGGCGCCTCTGGC -> TCACCCGGCGCCTCTGGCC
TTCACTCGAGGATCGTCTC -> TCACTCGAGGATCGTCTCA
TTCAGGGCCTCCGTGCCGA -> TCAGGGCCTCCGTGCCGAA
TTCATCGCCAGGGGCCAGC -> TCATCGCCAGGGGCCAGCG
TTCATCTACGCACCTCTTA -> TCATCTACGCACCTCTTAA
TTCCACGGCTCATTACCAG -> TCCACGGCTCATTACCAGG
TTCCCCTTGAATGAAGTTT -> TCCCCTTGAATGAAGTTTA
TTCCCGAATGGGCCAAATT -> TCCCGAATGGGCCAAATTT
TTCCCGAGAGAGAGTGTGA -> TCCCGAGAGAGAGTGTGAG
TTCCGCCTTCGGTTCTGCC -> TCCGCCTTCGGTTCTGCCA
TTCCGCGGGCTTACGACAC -> TCCGCGGGCTTACGACACC
TTCCGTGGGCGCCAAAGGT -> TCCGTGGGCGCCAAAGGTA
TTCGAAGTCTAGGTCACCA -> TCGAAGTCTAGGTCACCAT
TTCGAGCCATCTTTGGTGA -> TCGAGCCATCTTTGGTGAC
TTCGATGGACGACCGATCC -> TCGATGGACGACCGATCCT
TTCGCCACTCTATGACTGA -> TCGCCACTCTATGACTGAT
TTCGCCAGCCTGAAGACGT -> TCGCCAGCCTGAAGACGTG
TTCGCTAGCTCAACGCTAT -> TCGCTAGCTCAACGCTATG
TTCGGAGGGATGGAGCCAC -> TCGGAGGGATGGAGCCACG
TTCGGGTTCGTTTATGAAA -> TCGGGTTCGTTTATGAAAT
TTCGGTTCTGCCAATGCCT -> TCGGTTCTGCCAATGCCTT
TTCGTCCAGACAAGGAAGG -> TCGTCCAGACAAGGAAGGT
TTCGTTTATGAAATCTGGT -> TCGTTTATGAAATCTGGTT
TTCTCGCCATGGTAGCCAA -> TCTCGCCATGGTAGCCAAG
TTCTCTATTGAGTCGAGAC -> TCTCTATTGAGTCGAGACG
TTCTGAACGGTACTATCCC -> TCTGAACGGTACTATCCCC
TTCTGCATCAGTGTGCCCC -> TCTGCATCAGTGTGCCCCA
TTCTGCCAATGCCTTTAGA -> TCTGCCAATGCCTTTAGAA
TTCTGCTTTGGAAGCTAAC -> TCTGCTTTGGAAGCTAACA
TTCTGTAAGTAAACGTTAC -> TCTGTAAGTAAACGTTACA
TTGAAACATGCTTTCCCGA -> TGAAACATGCTTTCCCGAG
TTGAAGACTAGCCTACAAA -> TGAAGACTAGCCTACAAAG
TTGAATGAAGTTTAAGTTG -> TGAATGAAGTTTAAGTTGG
TTGACCCCGATCACATGTG -> TGACCCCGATCACATGTGC
TTGAGCTCTGAGTAGAGCG -> TGAGCTCTGAGTAGAGCGT
TTGAGTCGAGACGTAGTAT -> TGAGTCGAGACGTAGTATT
TTGAGTTTTGAAGACTAGC -> TGAGTTTTGAAGACTAGCC
TTGATACCCAATTTGTTAG -> TGATACCCAATTTGTTAGC
TTGATGAGTGGCGTGCTAC -> TGATGAGTGGCGTGCTACC
TTGATGTTGCTTGTTTCTC -> TGATGTTGCTTGTTTCTCG
TTGCAAGGCGGTAGGGAAG -> TGCAAGGCGGTAGGGAAGC
TTGCATAGTTGCCGCGGAC -> TGCATAGTTGCCGCGGACA
TTGCCGCGGACAAATGGTG -> TGCCGCGGACAAATGGTGC
TTGCCGTTCGAAGTCTAGG -> TGCCGTTCGAAGTCTAGGT
TTGCGGGTAGATTTAATCT -> TGCGGGTAGATTTAATCTC, TGCGGGTAGATTTAATCTC
TTGCTTGTTAAATGGGCTA -> TGCTTGTTAAATGGGCTAG
TTGCTTGTTTCTCGCCATG -> TGCTTGTTTCTCGCCATGG
TTGGAAGCTAACAACAAGT -> TGGAAGCTAACAACAAGTA
TTGGACGATAGCAATGGTT -> TGGACGATAGCAATGGTTT
TTGGATGGAACGTGGAAAA -> TGGATGGAACGTGGAAAAG
TTGGCGACCACTCCAGTTC -> TGGCGACCACTCCAGTTCG
TTGGTAATATCGGGGGGCC -> TGGTAATATCGGGGGGCCA
TTGGTATGACGCTTGCAAG -> TGGTATGACGCTTGCAAGG
TTGGTCAAAAACCACTGAT -> TGGTCAAAAACCACTGATA
TTGGTGACGGTTACAAAAG -> TGGTGACGGTTACAAAAGG
TTGTAATTCAAGCCTCTCC -> TGTAATTCAAGCCTCTCCC
TTGTACCCTGACGGCCTGG -> TGTACCCTGACGGCCTGGC
TTGTCGCCCAATTCACCCG -> TGTCGCCCAATTCACCCGG
TTGTCGCCCTTTGTACCCT -> TGTCGCCCTTTGTACCCTG
TTGTTAAATGGGCTAGACA -> TGTTAAATGGGCTAGACAA
TTGTTAGCTGTCTACGATA -> TGTTAGCTGTCTACGATAC
TTGTTTCTCGCCATGGTAG -> TGTTTCTCGCCATGGTAGC
TTTAAGTTGGACGATAGCA -> TTAAGTTGGACGATAGCAA
TTTAATCTCCCACCCGCTC -> TTAATCTCCCACCCGCTCC
TTTAATCTCCCACGAGCCC -> TTAATCTCCCACGAGCCCA
TTTAATCTCCCCGATTCAT -> TTAATCTCCCCGATTCATC
TTTAATCTCCTCCGACGGA -> TTAATCTCCTCCGACGGAA
TTTAATTGAGCTCTGAGTA -> TTAATTGAGCTCTGAGTAG
TTTAGAAACCGGCCTACCA -> TTAGAAACCGGCCTACCAG
TTTAGCAAGATTTATGAAC -> TTAGCAAGATTTATGAACA
TTTAGCGAGTGCGGGTAGA -> TTAGCGAGTGCGGGTAGAT
TTTAGTTGTCGCCCAATTC -> TTAGTTGTCGCCCAATTCA
TTTATGAAATCTGGTTAAT -> TTATGAAATCTGGTTAATT
TTTATGAACACGCCCCAGT -> TTATGAACACGCCCCAGTC
TTTATTCAGGGCCTCCGTG -> TTATTCAGGGCCTCCGTGC
TTTCAAACTGAATCAGGCA -> TTCAAACTGAATCAGGCAT
TTTCCCCTTGAATGAAGTT -> TTCCCCTTGAATGAAGTTT
TTTCCCGAGAGAGAGTGTG -> TTCCCGAGAGAGAGTGTGA
TTTCCGCCTTCGGTTCTGC -> TTCCGCCTTCGGTTCTGCC
TTTCGGAGGGATGGAGCCA -> TTCGGAGGGATGGAGCCAC
TTTCGGGTTCGTTTATGAA -> TTCGGGTTCGTTTATGAAA
TTTCTCGCCATGGTAGCCA -> TTCTCGCCATGGTAGCCAA
TTTCTGAACGGTACTATCC -> TTCTGAACGGTACTATCCC
TTTGAAGACTAGCCTACAA -> TTGAAGACTAGCCTACAAA
TTTGAGTTTTGAAGACTAG -> TTGAGTTTTGAAGACTAGC
TTTGCGGGTAGATTTAATC -> TTGCGGGTAGATTTAATCT
TTTGGAAGCTAACAACAAG -> TTGGAAGCTAACAACAAGT
TTTGGTGACGGTTACAAAA -> TTGGTGACGGTTACAAAAG
TTTGTACCCTGACGGCCTG -> TTGTACCCTGACGGCCTGG
TTTGTCGCCCTTTGTACCC -> TTGTCGCCCTTTGTACCCT
TTTGTTAGCTGTCTACGAT -> TTGTTAGCTGTCTACGATA
TTTTCGGAGGGATGGAGCC -> TTTCGGAGGGATGGAGCCA
TTTTGAAGACTAGCCTACA -> TTTGAAGACTAGCCTACAA
TTTTGAGTTTTGAAGACTA -> TTTGAGTTTTGAAGACTAG
TTTTGCGGGTAGATTTAAT -> TTTGCGGGTAGATTTAATC
